UID,Name,NationID,Born,Age,IntCaps,IntGoals,U21Caps,U21Goals,Height,Weight,AerialAbility,CommandOfArea,Communication,Eccentricity,Handling,Kicking,OneOnOnes,Reflexes,RushingOut,TendencyToPunch,Throwing,Corners,Crossing,Dribbling,Finishing,FirstTouch,Freekicks,Heading,LongShots,Longthrows,Marking,Passing,PenaltyTaking,Tackling,Technique,Aggression,Anticipation,Bravery,Composure,Concentration,Vision,Decisions,Determination,Flair,Leadership,OffTheBall,Positioning,Teamwork,Workrate,Acceleration,Agility,Balance,Jumping,LeftFoot,NaturalFitness,Pace,RightFoot,Stamina,Strength,Consistency,Dirtiness,ImportantMatches,InjuryProness,Versatility,Adaptability,Ambition,Loyalty,Pressure,Professional,Sportsmanship,Temperament,Controversy,PositionsDesc,Goalkeeper,Sweeper,Striker,AttackingMidCentral,AttackingMidLeft,AttackingMidRight,DefenderCentral,DefenderLeft,DefenderRight,DefensiveMidfielder,MidfielderCentral,MidfielderLeft,MidfielderRight,WingBackLeft,WingBackRight
6700151,Iker Casillas,796,20-05-1981,35,166,0,5,0,182,76,13,10,13,7,12,15,19,18,13,17,16,8,2,3,1,11,11,8,2,3,1,12,4,2,11,7,16,11,16,14,11,14,13,6,16,3,15,14,12,10,15,12,12,20,9,12,11,13,12,14,5,15,7,13,8,17,20,16,8,19,14,9,GK ,20,1,1,1,1,1,1,1,1,1,1,1,1,1,1
7458272,Sergio Ramos,796,30-03-1986,30,136,10,6,0,183,81,1,3,2,2,2,3,3,2,3,2,2,9,11,13,13,14,14,20,14,12,16,16,14,18,14,18,18,17,13,10,13,11,20,15,19,12,14,14,16,13,15,15,16,14,15,15,20,17,16,11,18,20,7,14,17,18,15,16,17,6,7,15,D C,1,9,1,1,1,1,20,1,14,12,10,1,1,1,13
4200583,Xavi,796,25-01-1980,36,133,13,25,7,170,67,3,1,3,3,1,1,1,2,2,3,1,16,13,12,11,20,15,7,12,6,6,20,15,8,18,6,19,8,20,17,20,20,17,9,17,15,11,18,6,8,10,17,6,9,11,7,20,10,8,16,9,16,7,9,20,15,20,18,18,14,13,3,M C,1,1,1,12,1,1,1,1,1,13,20,1,8,1,1
811316,Xabi Alonso,796,25-11-1981,34,114,16,9,0,183,77,2,2,4,3,3,3,3,4,2,1,1,14,15,10,10,14,15,12,17,10,11,20,17,14,16,11,19,14,18,19,18,18,18,11,17,8,15,18,10,8,9,14,11,15,15,8,20,12,13,16,12,16,8,5,16,13,15,17,18,12,10,9,DM/M C,1,1,1,1,1,1,1,1,1,20,20,1,1,1,1
824041,Andres Iniesta,796,11-05-1984,32,114,12,18,6,171,68,1,3,3,1,3,1,3,3,1,3,3,14,13,19,11,20,14,5,10,5,5,18,13,7,20,8,18,10,18,15,20,19,14,19,12,15,11,17,13,13,13,13,6,15,10,12,20,13,7,14,5,18,13,16,12,14,16,17,19,16,16,4,M/AM LC,1,1,1,19,17,13,1,1,1,9,20,16,12,1,1
5120110,Cesc Fabregas,796,04-05-1987,29,110,15,12,8,180,77,4,3,3,3,3,4,1,2,3,3,2,14,11,13,14,18,13,10,13,5,8,19,15,9,18,10,18,13,18,15,18,15,13,15,13,18,7,12,14,12,11,12,9,15,12,12,20,15,10,14,11,12,12,14,17,15,13,15,14,8,12,13,M/AM C,1,1,8,19,7,9,1,1,1,11,20,10,11,1,1
821112,Fernando Torres,796,20-03-1984,32,110,38,10,3,186,81,2,4,3,3,1,3,2,1,1,2,1,8,13,14,15,12,9,15,13,6,5,13,15,10,16,6,14,11,13,12,15,14,12,16,13,15,9,14,15,14,13,12,13,13,14,15,20,14,12,15,8,16,12,8,19,14,14,12,14,7,16,9,S ,1,1,20,1,1,12,1,1,1,1,1,1,1,1,1
7458280,David Silva,796,08-01-1986,30,103,24,9,7,170,67,1,3,2,4,1,1,1,2,3,3,1,13,12,18,11,19,11,7,12,7,5,19,12,5,19,10,13,11,16,15,19,16,15,19,10,18,8,14,13,15,17,17,5,20,11,11,13,13,8,15,9,13,13,13,13,16,13,15,11,12,13,7,M/AM RLC,1,1,9,20,19,15,1,1,1,4,15,19,15,1,1
813570,David Villa,796,01-12-1981,34,97,59,17,11,175,69,2,1,1,1,1,1,2,3,1,3,1,14,13,15,17,15,14,11,14,8,4,12,17,8,16,15,16,13,12,11,15,13,16,15,14,17,8,11,15,13,12,14,7,15,16,12,20,14,9,14,10,17,11,13,13,14,12,17,18,14,10,8,AM/S L,1,1,20,11,16,11,1,1,1,1,1,1,1,1,1
1510566,Sergio Busquets,796,16-07-1988,27,87,2,3,1,189,76,1,1,3,1,2,3,3,1,3,2,1,8,11,13,9,16,8,13,10,8,16,17,11,15,15,12,19,13,17,17,16,18,16,9,10,11,19,19,15,10,13,9,14,12,13,12,20,16,13,18,13,16,7,13,11,14,14,14,14,6,8,7,DM/M C,1,14,1,1,1,1,12,1,1,20,17,1,1,1,1
5124470,Gerard Pique,796,02-02-1987,29,80,5,12,1,193,85,3,1,1,1,1,1,2,3,2,2,3,8,10,13,10,15,7,16,8,8,16,16,13,15,16,14,16,15,18,15,15,17,13,11,16,9,18,15,15,11,10,9,16,12,15,13,20,15,15,16,12,18,8,9,16,15,14,14,12,9,10,16,D C,1,15,1,1,1,1,20,1,1,10,1,1,1,1,1
7456688,Santi Cazorla,796,13-12-1984,31,77,14,7,0,168,66,2,1,2,2,1,2,4,3,1,2,1,13,12,16,12,17,15,4,14,4,8,18,16,11,18,9,16,11,15,12,17,14,15,17,11,15,9,14,14,14,15,12,5,17,13,11,20,13,7,16,9,16,9,16,17,14,16,16,16,15,15,5,M/AM RLC,1,1,1,17,16,16,1,1,1,10,20,14,14,1,1
1510305,Pedro,796,28-07-1987,28,59,17,2,0,169,65,2,2,1,3,1,2,3,2,3,2,3,12,11,13,15,16,10,9,12,5,4,12,11,8,14,14,15,10,12,13,11,13,16,15,8,17,6,12,15,16,18,14,6,19,13,15,20,14,7,13,7,17,10,16,8,14,17,14,17,12,17,5,AM RLC,1,1,14,18,19,20,1,1,1,1,1,12,13,1,1
7451691,Alvaro Arbeloa,796,17-01-1983,33,56,0,1,0,184,79,2,2,1,3,1,2,3,2,3,2,2,6,11,7,6,11,6,12,7,14,18,11,5,15,8,14,14,15,13,19,9,15,16,7,14,12,16,18,15,10,10,11,13,8,13,12,20,13,12,20,14,12,9,16,16,13,16,12,16,5,7,13,D RL,1,1,1,1,1,1,11,19,20,1,1,1,1,12,13
7452450,Raul Albiol,796,04-09-1985,30,51,0,8,0,190,82,1,3,3,1,2,2,1,2,3,3,1,7,10,8,9,12,8,14,11,12,16,12,9,15,12,13,15,16,13,13,12,13,13,6,14,9,14,17,16,11,11,16,15,10,14,14,20,16,15,15,13,16,8,13,16,14,14,13,14,12,7,6,D C,1,9,1,1,1,1,20,1,10,10,1,1,1,1,1
814555,Joaquin,796,21-07-1981,34,51,4,7,0,179,75,3,1,3,1,3,2,4,1,2,4,2,16,16,16,12,16,9,8,11,7,6,16,11,8,16,7,13,10,15,11,15,14,12,17,8,14,7,13,10,14,14,12,9,10,11,14,20,11,10,13,8,15,2,14,14,13,13,14,13,10,13,9,M/AM R,1,1,1,14,12,20,1,1,1,1,1,5,19,1,1
67052513,Jordi Alba,796,21-03-1989,27,47,6,4,0,170,68,1,1,1,1,3,3,1,2,1,3,2,12,14,13,11,15,10,5,10,12,11,11,10,14,15,15,15,15,13,12,14,15,16,13,10,17,12,15,16,18,16,15,6,20,13,16,8,18,9,15,14,14,12,12,15,18,14,14,16,8,8,9,D/WB/M L,1,1,1,1,15,1,1,20,1,1,1,19,1,19,1
67011232,Juan Mata,796,28-04-1988,28,39,11,25,8,171,65,4,3,2,1,1,3,3,2,2,1,3,14,14,16,16,19,16,4,12,3,2,18,15,4,19,11,18,8,16,14,18,16,15,17,6,17,4,16,13,13,16,13,6,20,13,12,12,15,8,16,10,16,7,12,18,18,12,15,17,13,19,2,AM RLC,1,1,10,20,17,18,1,1,1,1,13,13,13,3,1
7456721,Jesus Navas,796,21-11-1985,30,34,3,5,0,170,60,2,3,3,3,2,3,2,1,1,2,2,11,11,13,7,13,9,5,10,5,6,11,12,6,13,8,13,9,10,10,12,8,13,10,12,15,6,12,16,18,18,10,6,9,13,17,20,15,7,11,10,14,12,9,5,14,16,10,16,13,13,10,M/AM R,1,1,1,10,7,20,1,1,1,1,1,6,20,1,1
6701096,Pepe Reina,796,31-08-1982,33,33,0,20,0,188,92,11,11,17,15,13,18,13,14,18,13,17,9,1,2,2,12,11,10,1,3,1,13,6,2,12,10,17,14,18,12,12,11,15,3,15,1,15,13,10,11,15,12,13,10,12,10,20,12,17,14,9,13,6,12,17,12,14,13,17,16,10,9,GK ,20,1,1,1,1,1,1,1,1,1,1,1,1,1,1
1501170,Fernando Llorente,796,26-02-1985,31,24,7,9,5,195,90,2,4,1,1,3,1,1,1,2,1,1,7,10,13,15,15,6,17,11,3,7,13,14,6,15,10,13,11,14,12,12,15,14,14,11,14,10,16,14,9,12,17,17,15,14,11,20,11,14,13,6,14,4,7,14,15,9,13,11,12,12,9,S ,1,1,20,1,1,1,1,1,1,1,1,1,1,1,1
67047092,Koke,796,08-01-1992,24,24,0,9,1,178,73,3,1,2,3,1,3,2,1,1,3,1,16,16,13,13,15,14,9,14,6,13,16,10,14,14,14,15,15,16,17,15,16,15,10,14,15,15,17,16,13,13,15,9,14,14,13,20,15,12,15,10,13,6,18,12,14,16,13,15,11,12,6,M RLC,1,1,1,14,11,9,1,1,1,12,20,19,16,1,1
6701501,Jose Antonio Reyes,796,01-09-1983,32,22,4,7,3,175,71,2,1,1,2,4,2,3,2,3,3,3,15,16,18,12,15,14,8,12,6,5,15,13,7,17,9,14,12,14,11,16,15,9,18,16,15,6,11,10,13,11,12,8,20,10,11,9,11,10,8,12,15,11,12,6,10,15,10,10,8,11,11,M/AM RLC,1,1,1,19,20,20,1,1,1,1,1,19,16,1,1
1501655,Alvaro Negredo,796,20-08-1985,30,21,10,1,0,186,86,2,2,3,2,1,3,1,2,3,1,2,8,13,13,15,14,7,16,15,7,9,13,16,10,14,14,16,15,13,12,13,12,13,13,12,13,9,15,8,10,10,17,15,20,11,13,12,13,17,10,12,14,11,10,12,13,15,12,12,17,11,7,S ,1,1,20,1,1,1,1,1,1,1,1,1,1,1,1
824039,Victor Valdes,796,14-01-1982,34,20,0,11,0,183,78,13,10,11,11,13,15,15,15,16,13,15,8,1,2,3,13,10,7,2,3,3,14,1,2,12,11,13,14,16,13,12,11,12,9,16,3,14,12,14,10,12,14,11,6,12,9,20,10,14,15,12,17,18,12,8,11,13,16,17,11,9,11,GK ,20,1,1,1,1,1,1,1,1,1,1,1,1,1,1
1512305,Javi Martinez,796,02-09-1988,27,18,0,24,1,190,86,3,3,2,3,3,2,2,2,3,3,1,7,10,9,12,14,7,13,10,8,15,13,11,16,14,12,18,14,16,17,12,15,15,9,14,12,17,18,14,9,11,17,16,14,14,12,20,14,16,18,10,18,12,15,14,17,12,16,17,13,13,4,D/DM/M C,1,1,5,10,1,8,20,1,1,17,16,1,8,1,1
1509608,Nacho Monreal,796,26-02-1986,30,16,0,9,0,178,72,1,3,3,2,3,3,3,1,3,1,1,7,12,12,7,12,7,15,7,14,16,13,7,16,13,14,15,15,15,16,10,15,15,6,8,12,15,16,15,14,13,14,12,20,14,14,8,16,12,16,10,18,9,8,15,12,14,14,16,14,16,6,D L,1,1,1,1,1,1,14,20,1,1,1,10,1,14,1
67033300,Cesar Azpilicueta,796,28-08-1989,26,16,0,22,1,178,78,1,2,2,3,2,2,3,2,1,4,1,8,10,10,6,11,7,9,10,11,14,10,8,16,13,12,15,16,14,15,9,15,16,8,13,12,15,17,20,15,14,12,9,15,17,15,20,20,9,19,12,15,5,16,12,14,18,16,18,15,12,6,D/WB RLC,1,1,1,1,1,1,18,19,20,1,1,1,1,16,15
815776,Albert Riera,796,15-04-1982,34,16,4,15,2,188,80,2,3,3,1,2,3,1,1,2,2,3,13,14,12,13,12,14,11,12,10,8,14,13,11,14,12,14,10,14,11,12,14,8,12,9,13,12,14,12,9,11,13,14,20,10,10,8,10,11,12,15,12,10,13,12,11,8,13,7,7,10,17,D/WB/M/AM L,1,1,1,7,16,5,1,18,1,1,8,20,7,18,1
67103537,Isco,796,21-04-1992,24,14,1,18,9,175,74,3,1,1,1,2,2,3,3,2,3,1,15,15,18,13,18,14,9,15,8,5,17,15,8,18,10,15,8,15,13,18,15,16,18,13,13,8,10,10,14,14,17,8,14,10,12,20,13,10,12,10,15,3,15,15,16,8,17,12,13,11,9,M/AM RLC,1,1,11,20,16,16,1,1,1,1,15,19,18,1,1
824068,Raul Bravo,796,14-06-1981,35,14,0,3,0,176,72,3,3,2,4,3,2,1,3,2,2,3,10,12,11,6,12,8,11,10,14,13,12,6,12,11,16,14,16,13,12,10,13,16,9,13,8,14,13,13,10,11,14,9,20,13,11,5,10,11,13,10,14,8,14,15,12,14,15,15,14,9,7,D/WB LC,1,1,1,1,1,1,19,20,1,1,1,10,1,16,1
67017094,Nolito,796,15-10-1986,29,13,5,0,0,175,73,1,3,3,3,3,1,1,2,1,3,3,15,12,15,14,15,12,9,13,6,4,13,15,10,16,9,13,12,14,13,13,14,10,16,14,15,10,12,10,15,15,14,9,15,12,13,20,14,13,12,14,14,7,12,12,14,12,10,10,7,10,12,AM/S L,1,1,16,13,20,12,1,1,1,1,1,14,9,1,1
67030171,David De Gea,796,07-11-1990,25,13,0,27,0,193,76,15,15,14,10,18,16,15,19,12,6,10,8,3,2,1,14,11,2,3,3,2,12,2,1,13,7,17,15,16,17,8,15,17,5,8,10,16,10,9,13,17,11,13,12,10,13,20,12,14,18,5,15,5,14,17,14,15,16,16,15,19,7,GK ,20,1,1,1,1,1,1,1,1,1,1,1,1,1,1
67115584,Paco Alcacer,796,30-08-1993,22,13,6,1,0,176,71,2,2,3,3,4,2,2,4,3,2,2,7,8,12,15,17,10,15,12,6,7,12,16,10,13,14,15,14,14,12,12,15,15,13,14,17,9,14,15,14,14,13,9,14,13,14,20,14,12,11,10,16,10,8,9,14,14,13,15,12,12,7,S ,1,1,20,8,6,1,1,1,1,1,1,1,1,1,1
67117360,Alvaro Morata,796,23-10-1992,23,13,6,13,13,187,80,2,3,2,2,3,2,2,3,3,2,3,5,10,14,16,16,11,14,14,9,7,14,14,10,15,15,14,14,15,13,11,13,15,14,12,16,9,12,15,15,15,10,14,12,13,17,20,14,14,13,15,17,9,11,17,17,14,17,14,10,9,7,S ,1,1,20,10,14,1,1,1,1,1,1,1,1,1,1
7451701,Juanfran,796,09-01-1985,31,13,1,9,0,181,72,1,2,3,1,4,4,1,3,1,1,3,15,15,14,11,14,9,7,13,11,13,14,12,13,14,13,13,14,14,14,14,13,16,12,12,15,15,15,16,15,15,13,11,12,12,15,20,14,11,15,10,13,7,14,15,17,15,14,15,14,10,8,D/WB R,1,1,1,1,1,1,1,1,20,1,1,1,13,1,18
67022040,Thiago,796,11-04-1991,25,12,0,21,6,174,70,3,4,3,1,2,2,2,2,2,2,1,15,14,17,13,19,13,12,14,5,9,18,13,12,19,15,16,8,18,10,19,13,11,18,8,13,12,10,15,14,18,13,7,11,11,11,20,15,7,13,6,12,16,12,14,16,11,13,13,8,10,12,DM/M/AM C,1,1,1,18,11,11,1,1,1,16,20,11,11,1,1
7443119,Roberto Soldado,796,27-05-1985,31,12,7,9,6,179,72,2,2,1,3,3,3,2,2,2,2,1,7,11,12,14,11,13,14,12,6,6,13,16,8,13,16,14,15,12,14,13,14,16,14,15,15,10,14,15,14,15,14,10,15,15,15,20,15,12,14,15,3,7,11,8,15,15,6,18,7,7,8,S ,1,1,20,12,1,1,1,1,1,1,1,1,1,1,1
55002038,Diego Costa,796,07-10-1988,27,10,1,0,0,186,87,1,1,2,2,3,1,3,1,1,2,1,11,13,12,15,15,11,15,11,7,4,12,15,7,12,20,16,20,14,13,14,15,19,15,13,17,6,17,18,14,12,14,14,15,10,15,20,14,17,15,18,16,7,13,16,16,11,15,14,5,3,13,S ,1,1,20,13,9,12,1,1,1,1,1,1,1,1,1
67063004,Marc Bartra,796,15-01-1991,25,10,0,16,2,184,73,2,1,1,2,2,3,2,1,2,1,1,7,10,12,9,14,7,15,8,12,17,13,9,17,14,15,18,14,18,15,12,13,14,10,11,10,12,10,15,14,14,11,13,10,13,12,20,14,11,15,8,13,7,8,10,12,16,13,16,14,12,7,D C,1,14,1,1,1,1,20,8,14,1,1,1,1,5,12
5108390,Wayne Rooney,765,24-10-1985,30,115,53,0,0,178,78,4,1,1,4,2,3,2,2,2,3,2,14,15,12,15,11,14,14,14,7,7,15,16,9,15,17,14,18,13,12,14,14,15,14,15,15,9,17,14,12,11,15,11,14,12,13,20,14,15,10,15,16,12,12,15,18,6,12,7,8,10,16,M/AM/S C,5,1,18,20,14,13,1,1,1,1,16,11,11,1,1
4001563,Ashley Cole,765,20-12-1980,35,107,0,4,1,176,66,1,1,3,2,4,2,2,1,4,2,3,8,11,11,9,13,9,8,8,10,10,12,15,14,13,16,15,16,16,13,10,15,18,8,18,14,14,15,16,8,12,14,7,20,12,9,10,10,11,18,14,19,10,10,16,14,9,18,10,7,9,18,D L,1,1,1,1,1,1,1,20,1,1,1,12,1,14,1
108625,John Terry,765,07-12-1980,35,78,6,9,1,187,90,2,3,2,3,1,2,3,1,2,3,1,6,6,8,10,12,4,18,5,4,15,13,11,13,15,16,17,20,15,16,10,16,19,6,20,8,15,20,17,7,7,12,14,17,18,8,20,14,14,16,12,16,9,7,13,18,20,15,19,10,10,18,D C,1,1,1,1,1,1,20,1,1,1,1,1,1,1,1
5119142,Joe Hart,765,19-04-1987,29,63,0,21,0,196,81,15,15,17,14,17,11,19,17,14,16,14,3,3,2,1,9,7,7,1,1,1,8,13,3,7,10,11,14,10,13,3,13,16,4,14,2,12,12,12,13,15,11,17,10,13,7,20,14,14,13,4,14,7,13,9,14,12,12,13,7,15,5,GK ,20,1,1,1,1,1,1,1,1,1,1,1,1,1,1
2004403,Emile Heskey,765,11-01-1978,38,62,7,17,6,186,93,4,1,2,2,3,1,1,2,1,3,3,8,8,8,9,12,6,14,8,7,10,12,9,10,12,10,14,14,12,15,12,12,11,9,14,12,10,15,10,8,8,10,15,11,9,9,20,8,16,12,8,13,9,14,8,14,15,12,16,15,15,5,S ,1,1,20,14,13,10,12,1,1,1,1,10,1,1,1
5106363,James Milner,765,04-01-1986,30,61,1,46,9,176,70,1,3,3,2,1,2,1,1,2,2,3,11,14,13,10,14,7,8,9,7,12,13,15,14,13,14,14,16,14,14,13,13,17,12,15,13,14,17,18,12,13,13,8,10,17,12,20,16,14,15,8,15,6,19,14,15,15,14,18,12,14,6,WB/DM/M/AM RLC,1,1,9,10,16,16,1,15,13,16,20,18,18,16,14
104062,Joe Cole,765,08-11-1981,34,56,10,8,2,176,73,2,2,3,1,2,1,3,1,2,1,2,13,14,12,10,14,14,6,12,6,4,14,13,7,14,8,12,10,12,13,14,15,16,15,15,14,10,9,8,10,12,11,7,13,8,10,20,12,10,11,8,15,9,13,14,16,15,14,11,15,15,5,M/AM RLC,1,1,3,20,16,16,1,1,1,1,16,12,12,1,1
127925,Jermain Defoe,765,07-10-1982,33,55,19,23,7,167,71,2,2,1,3,3,3,3,3,3,2,1,8,8,14,16,14,8,10,13,5,4,11,13,9,15,12,13,10,16,15,11,13,15,13,13,16,9,15,15,14,15,15,6,15,18,15,20,15,9,12,13,14,3,12,11,15,7,12,16,8,9,3,S ,1,1,20,1,10,1,1,1,1,1,1,1,1,1,1
5112082,Glen Johnson,765,23-08-1984,31,54,1,14,0,182,70,2,3,2,3,2,4,1,2,3,1,3,3,13,13,10,13,8,13,12,6,13,10,12,14,15,11,14,13,14,13,13,12,13,12,7,13,12,14,14,12,15,16,13,15,15,12,20,15,15,12,7,13,13,15,15,15,15,12,15,16,14,5,D R,1,1,1,1,1,13,12,14,20,1,1,1,14,14,14
108586,Gareth Barry,765,23-02-1981,35,53,3,27,2,183,78,1,2,2,3,1,1,3,2,3,2,3,10,13,8,11,14,12,12,10,8,14,16,12,14,15,14,16,14,17,15,11,14,15,8,16,11,17,18,14,8,9,12,11,20,15,9,12,11,14,15,16,14,4,15,2,12,13,13,15,12,14,2,DM/M C,1,1,1,1,1,1,10,12,1,20,19,6,1,1,1
5112583,Gary Cahill,765,19-12-1985,30,47,3,1,0,193,86,1,2,3,3,3,3,3,3,2,2,3,3,5,10,9,11,4,15,8,6,15,13,6,17,13,14,14,19,15,14,13,13,14,14,16,13,14,15,16,13,11,13,14,8,14,12,20,16,15,13,9,18,7,7,18,16,12,16,14,12,13,5,D C,1,1,1,1,1,1,20,1,1,1,1,1,1,1,1
5125014,Theo Walcott,765,16-03-1989,27,43,8,21,6,176,71,3,1,3,3,1,1,1,3,1,1,1,13,11,14,14,12,10,5,7,3,6,12,10,7,13,9,12,10,13,12,11,12,13,13,3,14,8,13,14,19,16,12,7,9,13,18,20,14,9,12,4,13,13,14,12,17,15,11,15,18,17,7,AM/S R,1,1,18,1,12,20,1,1,1,1,1,8,14,1,1
4000327,Peter Crouch,765,30-01-1981,35,42,22,6,1,200,84,1,1,3,1,1,2,2,3,2,1,2,7,9,8,14,13,6,14,11,12,7,12,12,9,14,12,15,16,17,15,14,16,14,14,13,17,4,17,18,2,12,12,18,11,15,14,20,11,13,12,8,15,5,8,16,15,14,10,16,14,11,4,S ,1,1,20,1,1,1,10,1,1,1,1,1,1,1,1
108640,Paul Robinson,765,15-10-1979,36,41,0,14,0,194,90,14,12,14,5,13,15,14,11,9,12,10,2,1,1,2,8,7,6,3,1,3,12,12,4,6,6,11,16,14,13,11,14,14,3,16,3,13,16,8,4,8,13,15,9,4,4,20,8,14,12,5,12,15,3,14,15,15,14,18,18,14,1,GK ,20,1,1,1,1,1,1,1,1,1,1,1,1,1,1
5101381,Phil Jagielka,765,17-08-1982,33,39,3,6,2,180,87,3,1,4,2,1,3,2,3,2,2,3,5,7,6,6,10,5,15,8,10,14,11,14,15,10,10,15,16,14,12,7,17,16,5,15,7,14,14,10,13,10,9,12,8,15,12,20,15,14,12,5,16,1,14,7,14,17,14,16,15,15,1,D C,1,1,1,1,1,1,20,1,14,10,1,1,1,1,1
4001249,Shaun Wright-Phillips,765,25-10-1981,34,36,6,6,1,166,65,1,1,1,1,1,1,1,1,1,1,1,9,10,12,9,10,9,9,11,6,10,11,10,10,11,11,12,14,11,14,11,11,12,10,8,12,12,15,9,13,12,12,3,9,15,13,20,11,8,10,4,10,4,12,18,10,15,13,13,16,16,3,M/AM R,1,1,1,11,9,19,1,1,1,1,5,9,20,1,10
5113374,Stewart Downing,765,22-07-1984,31,35,0,8,0,180,65,1,1,2,3,1,3,3,2,3,3,3,12,16,12,9,14,13,9,12,8,8,14,12,7,13,4,11,4,12,14,14,14,10,10,9,10,7,12,12,12,12,11,8,20,12,13,10,14,8,11,5,13,5,14,16,12,8,11,15,13,14,9,M/AM RLC,1,1,1,18,20,16,1,11,1,1,17,18,15,1,1
122025,Michael Carrick,765,28-07-1981,34,34,0,14,2,188,74,2,1,1,1,3,1,1,3,2,2,4,13,13,5,8,16,10,12,9,8,14,18,14,14,17,8,18,8,18,18,14,19,16,6,12,10,18,18,11,7,8,14,13,16,14,9,20,11,13,17,7,12,13,8,8,15,14,15,18,18,19,1,DM/M C,1,1,1,6,1,1,10,1,1,20,18,1,1,1,1
28010491,Danny Welbeck,765,26-11-1990,25,34,14,14,5,185,73,3,1,2,4,2,3,2,3,3,3,2,5,9,14,15,13,4,13,8,3,6,12,10,6,14,11,13,14,12,12,10,14,14,17,4,14,8,16,17,17,15,16,14,12,15,17,20,15,14,14,5,12,12,12,9,15,16,14,15,11,15,4,AM/S RL,1,1,20,10,18,17,1,1,1,1,1,1,1,1,1
29024338,Jack Wilshere,765,01-01-1992,24,34,2,7,0,174,65,2,3,2,3,2,1,1,4,3,3,3,12,12,15,11,16,11,6,12,3,8,15,12,12,16,15,15,17,14,14,16,15,13,16,13,16,11,17,15,14,14,16,6,20,13,13,8,14,11,14,13,15,15,15,11,15,17,14,12,10,10,14,M/AM C,1,1,1,20,14,14,1,1,1,12,20,14,14,1,1
5112801,Leighton Baines,765,11-12-1984,31,30,1,16,1,170,74,3,2,2,2,1,2,1,1,1,1,3,13,14,12,8,14,15,10,12,9,14,14,18,14,15,7,14,12,16,14,14,15,15,12,11,15,13,15,14,11,13,13,6,20,15,14,10,14,11,13,6,13,9,12,1,15,17,16,17,17,17,1,D L,1,1,1,1,1,1,1,20,1,7,1,7,1,15,1
5113149,Ashley Young,765,09-07-1985,30,30,7,10,0,175,65,1,3,2,1,2,3,2,3,4,1,2,14,14,12,10,14,12,5,13,3,9,12,12,10,13,7,11,6,9,14,9,13,12,14,5,13,12,13,16,15,15,12,7,9,15,15,20,14,10,12,8,15,5,13,8,12,8,12,13,4,14,4,M/AM RL,1,1,12,14,19,16,1,14,14,1,1,20,15,14,14
30022142,Chris Smalling,765,22-11-1989,26,29,1,14,1,194,90,1,2,3,4,1,2,3,3,3,2,2,4,4,7,7,11,2,17,2,8,15,8,4,16,12,14,16,15,11,13,3,14,14,5,12,4,16,15,14,13,12,14,16,9,12,14,20,16,17,14,8,13,11,8,17,14,13,13,15,16,17,6,D C,1,1,1,1,1,1,20,1,14,1,1,1,1,1,1
28005568,Jordan Henderson,765,17-06-1990,26,27,0,27,4,183,67,1,3,4,2,3,2,2,1,3,1,2,12,13,12,11,15,11,11,12,4,13,16,10,14,14,14,14,14,15,15,14,15,17,13,16,14,15,17,18,13,13,13,12,8,18,14,20,18,14,15,8,15,9,13,15,17,17,17,18,13,15,6,DM/M C,1,1,1,8,4,10,1,1,8,20,20,10,14,1,12
28054109,Raheem Sterling,765,08-12-1994,21,26,2,8,3,171,69,2,1,2,1,3,2,2,3,2,1,2,10,11,15,12,13,10,5,9,9,9,12,7,9,13,13,13,13,11,10,12,10,13,15,4,13,10,14,13,17,16,13,4,9,15,16,20,14,10,13,4,11,5,18,11,16,7,8,15,10,14,8,M/AM RLC,1,1,15,18,20,20,1,1,10,1,1,16,14,1,12
5101074,Joleon Lescott,765,16-08-1982,33,26,1,2,0,190,93,1,2,1,2,1,3,2,1,3,2,2,5,9,8,6,10,4,15,2,9,14,9,2,15,10,12,14,15,13,12,6,13,13,5,13,8,15,12,12,10,11,13,15,20,12,11,9,14,17,12,9,13,12,14,14,12,10,15,10,14,15,13,D C,1,1,1,1,1,1,20,14,1,1,1,1,1,1,1
5125012,Adam Lallana,765,10-05-1988,28,26,0,1,0,173,73,2,1,4,2,1,3,3,2,1,2,3,11,13,17,13,17,10,6,11,2,10,15,9,10,18,9,15,11,15,12,15,14,15,17,12,16,13,15,17,13,16,15,6,16,15,10,20,15,10,15,7,14,11,12,13,14,16,13,15,12,13,9,M/AM RLC,1,1,1,20,17,18,1,1,1,1,19,15,16,1,1
28046572,Alex Oxlade-Chamberlain,765,15-08-1993,22,24,5,8,4,181,72,2,3,1,1,3,2,2,2,3,3,3,10,12,16,11,13,8,7,12,4,5,13,9,7,16,8,12,13,12,13,14,12,15,17,7,13,8,13,14,17,14,13,7,13,15,16,20,13,12,13,6,13,13,16,12,17,14,16,15,14,15,3,AM RL,1,1,8,12,17,20,1,1,1,8,12,12,14,1,1
2003610,Wes Brown,765,13-10-1979,36,23,1,8,0,185,77,2,1,2,3,2,2,3,2,2,1,1,7,9,7,6,10,5,16,5,10,13,8,6,16,10,14,14,14,13,10,5,14,8,3,9,6,15,15,11,10,10,12,13,10,2,9,20,5,12,10,12,10,19,5,11,4,18,14,16,15,10,1,D RC,1,1,1,1,1,1,20,1,16,1,1,1,1,1,1
28058224,Ross Barkley,765,05-12-1993,22,22,2,5,1,189,76,1,1,2,4,2,2,4,4,2,2,3,11,12,16,12,16,14,13,14,9,6,15,12,8,15,8,15,11,14,11,14,10,12,14,8,13,8,13,12,15,11,15,11,15,13,14,20,12,18,11,6,10,8,8,5,14,15,13,15,12,13,1,M/AM C,1,1,1,20,13,13,1,1,1,14,20,1,1,1,1
2005781,Matthew Upson,765,18-04-1979,37,21,2,12,2,185,72,3,3,2,2,2,1,3,3,2,1,1,5,6,7,6,11,5,14,5,7,13,12,6,14,11,8,14,14,13,13,10,14,14,4,14,6,14,12,9,7,7,12,12,20,12,6,9,10,13,16,8,16,18,4,12,14,10,14,20,14,14,5,D C,1,1,1,1,1,1,20,14,1,1,1,1,1,1,1
5109664,Aaron Lennon,765,16-04-1987,29,21,0,5,0,165,63,1,2,2,4,2,4,3,1,3,1,3,7,13,14,9,14,7,7,4,5,7,14,9,10,15,5,14,9,10,13,10,12,11,10,4,15,10,17,17,16,14,12,5,10,12,14,20,15,8,10,6,11,5,14,10,15,14,11,13,10,14,4,M/AM RL,1,1,1,13,15,20,1,1,1,1,1,10,20,1,1
5127717,Daniel Sturridge,765,01-09-1989,26,21,6,15,4,183,79,1,2,1,2,1,3,1,3,1,3,1,7,12,15,16,16,10,11,13,3,7,13,13,7,16,12,15,11,15,14,14,13,11,15,4,16,5,12,12,14,17,16,11,20,10,13,13,14,13,15,5,15,14,9,13,18,13,13,14,13,16,8,S ,1,1,20,10,12,12,1,1,1,1,1,1,1,1,1
28027433,Phil Jones,765,21-02-1992,24,20,0,9,0,185,72,3,2,3,3,4,2,4,3,1,2,2,5,13,9,6,13,6,16,4,8,15,13,8,17,13,15,14,19,11,13,6,12,19,8,13,6,14,14,16,14,11,14,12,11,14,14,20,17,16,13,13,18,15,15,7,18,8,15,18,15,16,8,D RC,1,1,1,1,1,1,20,1,15,13,10,1,1,1,1
108642,Alan Smith,765,28-10-1980,35,19,1,10,3,178,69,1,1,1,1,1,1,1,1,1,1,1,7,7,8,9,11,6,11,8,4,11,10,11,12,11,16,12,15,10,11,12,10,15,5,14,9,12,12,9,6,8,13,9,10,10,7,20,8,14,9,15,13,14,9,11,7,15,13,15,10,8,11,DM/M C,1,1,14,7,1,1,1,1,1,20,20,1,1,1,1
28009441,Kyle Walker,765,28-05-1990,26,19,0,7,0,183,74,2,1,1,1,3,2,2,1,2,2,3,13,13,14,7,12,12,15,7,14,12,12,6,13,12,11,13,15,13,13,11,9,13,10,12,12,12,15,16,18,15,15,12,10,13,18,20,15,15,13,5,12,6,14,9,15,14,7,8,12,11,7,D/WB R,1,1,1,1,1,5,12,10,20,1,1,1,5,1,18
103424,Scott Parker,765,13-10-1980,35,18,0,9,0,180,69,1,1,1,2,3,4,1,2,1,2,1,9,10,13,10,13,10,11,9,8,14,13,10,15,10,16,15,18,15,15,9,14,18,7,18,10,14,18,16,7,7,12,6,11,16,7,20,11,12,15,9,15,13,5,14,12,12,14,18,18,15,4,DM/M C,1,1,1,1,1,1,1,1,1,18,20,1,1,1,1
28049320,Harry Kane,765,28-07-1993,22,16,5,14,8,190,83,1,2,1,1,3,2,3,2,2,2,2,6,11,12,16,13,10,16,15,6,8,12,14,5,14,9,14,15,15,17,13,14,16,8,12,15,10,15,16,14,12,14,15,15,16,13,20,16,14,15,8,13,5,9,7,9,18,12,16,12,12,5,S ,1,1,20,13,10,1,1,1,1,1,10,1,1,1,1
28000906,Tom Cleverley,765,12-08-1989,26,13,0,16,0,175,67,2,2,2,2,2,2,2,2,2,2,2,12,13,10,10,14,7,6,10,9,7,13,8,9,14,14,12,13,13,14,14,14,18,8,9,14,10,17,15,14,17,10,7,14,15,12,20,15,8,13,10,10,13,16,7,13,14,13,16,15,14,2,M C,1,1,1,10,14,10,1,6,6,10,20,14,10,1,1
28019851,Nathaniel Clyne,765,05-04-1991,25,13,0,8,0,176,67,1,3,1,2,1,3,3,1,1,2,2,3,12,13,8,14,3,8,8,9,14,14,5,16,13,13,13,14,12,13,11,14,15,10,9,15,14,17,16,16,15,14,8,8,18,16,20,17,12,17,8,15,5,12,16,15,15,15,15,13,15,7,D/WB R,1,1,1,1,1,1,1,14,20,1,1,1,1,13,19
5005673,Micah Richards,765,24-06-1988,28,13,1,15,3,181,83,1,2,1,2,1,3,1,3,1,3,3,3,10,10,6,10,5,15,4,15,12,10,5,13,9,14,11,18,10,10,6,12,9,4,11,10,12,10,13,12,11,14,14,8,16,13,20,13,17,9,8,12,19,16,8,10,15,11,9,13,11,10,D RC,1,1,5,1,1,1,18,5,20,10,10,1,1,1,12
5102384,Darren Bent,765,06-02-1984,32,13,4,14,9,180,74,1,2,2,3,4,1,3,3,4,2,1,7,11,11,13,12,10,13,9,6,5,10,16,7,11,7,13,11,13,12,10,13,8,8,10,13,8,8,10,11,13,13,12,12,15,11,20,11,12,11,6,14,8,8,14,15,12,11,8,9,16,14,S ,1,1,20,1,5,10,1,1,1,1,1,1,5,1,1
107539,Robert Green,765,19-01-1980,36,12,0,0,0,191,93,14,13,16,8,15,9,15,15,14,9,12,1,1,1,1,10,1,5,1,1,1,4,1,10,10,5,13,13,13,15,8,13,19,1,12,1,13,15,14,6,12,12,14,8,15,4,20,13,11,15,2,13,7,11,7,14,15,13,13,14,10,12,GK ,20,1,1,1,1,1,1,1,1,1,1,1,1,1,1
29085579,Dele Alli,765,11-04-1996,20,12,1,2,0,185,77,3,3,1,1,3,1,4,1,1,1,4,8,12,15,16,14,8,14,14,9,12,16,12,12,15,14,13,15,15,14,15,13,14,16,7,14,13,14,16,15,15,14,13,8,14,14,20,15,13,15,12,12,4,15,13,17,13,12,15,10,9,2,M/AM C,1,1,1,20,10,12,1,1,1,13,20,1,12,1,1
28005834,Andros Townsend,765,16-07-1991,24,11,3,3,0,178,75,3,2,1,2,1,4,2,2,2,2,3,11,12,16,9,11,11,7,15,5,5,10,6,6,13,8,8,10,7,12,10,11,13,16,10,11,9,11,13,16,13,13,8,20,12,16,16,15,11,9,4,10,7,9,12,10,13,12,13,10,14,6,M/AM RL,1,1,8,10,19,20,1,1,1,1,1,17,18,1,1
4001311,Rickie Lambert,765,16-02-1982,34,11,3,0,0,188,77,2,2,1,1,1,3,2,1,1,3,3,11,13,10,14,13,14,16,15,10,11,12,18,11,14,12,14,15,14,14,13,14,10,12,16,13,12,15,15,8,8,14,13,13,11,8,20,9,16,13,8,14,8,13,6,11,9,13,14,10,14,4,AM/S C,1,1,20,16,1,1,1,1,1,1,12,1,1,1,1
55032265,Eric Dier,765,15-01-1994,22,11,2,9,0,188,86,2,3,2,1,3,1,1,2,3,3,3,3,13,8,7,14,12,15,9,5,15,13,8,15,13,13,15,16,15,14,11,14,15,5,12,10,17,14,15,16,12,12,13,8,14,15,20,13,13,17,5,10,13,17,16,13,17,14,16,14,14,5,D/DM/M RC,1,1,1,1,1,1,20,13,15,20,20,1,1,1,1
90008752,Jamie Vardy,765,11-01-1987,29,11,4,0,0,178,77,1,3,1,1,3,1,2,1,3,1,2,7,10,12,16,13,7,12,10,5,3,12,16,13,13,17,13,17,13,15,12,12,17,12,10,14,5,17,17,17,12,12,11,10,16,18,20,17,14,14,17,15,7,10,8,16,13,15,14,5,7,17,S ,1,1,20,10,12,12,1,1,1,1,1,10,12,1,1
28060397,John Stones,765,28-05-1994,22,10,0,12,0,189,77,1,1,2,4,4,2,3,1,3,2,3,5,11,12,8,13,5,15,5,8,15,14,15,16,12,10,12,15,17,12,12,13,13,10,12,11,14,12,14,13,12,16,14,12,19,15,20,13,14,12,9,12,5,10,10,20,15,16,14,13,16,5,D RC,1,1,1,1,1,1,20,1,16,1,1,1,1,1,1
29003721,Kieran Gibbs,765,26-09-1989,26,10,0,15,3,178,66,1,2,2,2,1,1,1,2,1,1,1,10,13,14,7,12,6,9,8,12,14,12,6,14,14,11,15,14,13,14,11,13,14,11,6,13,13,15,16,17,16,13,10,20,15,15,8,15,9,13,8,14,11,12,16,14,17,14,15,14,17,6,D L,1,1,1,1,12,1,1,20,1,1,1,12,1,14,1
29001228,Fabian Delph,765,21-11-1989,26,9,0,4,0,174,60,3,3,1,1,3,3,2,1,3,1,2,10,11,12,11,12,10,3,9,4,7,12,8,14,12,15,13,15,12,14,13,14,12,14,16,14,13,17,17,17,18,14,8,20,13,14,7,16,12,12,16,10,15,12,12,16,15,11,14,7,3,4,M C,1,1,1,13,1,1,1,1,1,10,20,10,14,1,1
5128259,Andy Carroll,765,06-01-1989,27,9,2,5,2,193,79,1,2,1,2,2,1,2,1,1,3,4,4,13,11,14,14,7,19,11,6,8,12,13,10,12,15,13,18,13,13,10,11,14,10,10,13,9,15,16,10,9,16,19,20,11,13,10,13,18,13,12,13,17,8,12,11,10,13,5,7,11,15,S ,1,1,20,8,1,1,1,1,1,1,1,1,1,1,1
5131224,Ryan Bertrand,765,05-08-1989,26,9,0,16,0,179,76,1,1,1,2,1,1,2,2,3,3,3,11,13,13,10,11,13,9,4,8,13,12,10,14,13,11,13,14,13,12,11,15,16,9,10,10,14,12,15,17,13,11,8,20,16,14,10,16,12,18,6,12,5,15,15,15,10,15,18,14,17,5,D LC,1,1,1,1,13,1,18,20,10,1,1,13,1,13,1
5104413,Ben Foster,765,03-04-1983,33,8,0,0,0,193,90,17,14,14,9,16,14,16,16,15,9,16,1,1,1,1,10,1,2,1,1,1,6,8,2,9,6,13,14,10,14,5,12,15,1,8,8,13,8,8,10,15,13,16,20,16,9,10,14,13,12,2,14,10,1,16,15,14,10,16,15,17,2,GK ,20,1,1,1,1,1,1,1,1,1,1,1,1,1,1
5107571,Kieran Richardson,765,21-10-1984,31,8,2,12,1,178,69,3,2,1,4,3,2,2,1,2,1,3,11,11,11,12,12,14,7,11,9,10,12,13,11,13,14,10,9,10,8,11,11,12,11,9,11,11,14,14,13,13,10,7,20,14,13,10,10,9,13,8,8,13,15,9,9,10,10,10,8,8,10,D/M/AM LC,1,1,1,13,16,1,1,20,1,1,16,18,8,14,1
5107884,Carlton Cole,765,12-10-1983,32,7,0,19,6,190,78,1,2,3,3,1,2,3,1,2,1,1,6,11,10,12,8,5,14,9,7,11,12,12,11,9,10,11,11,8,12,11,9,14,12,9,11,10,17,16,11,12,16,15,8,12,15,20,14,17,11,6,12,10,6,6,13,17,7,11,15,15,14,S ,1,1,20,1,1,1,1,1,1,1,1,1,1,1,1
5134489,Danny Rose,765,02-07-1990,26,7,0,29,3,172,73,3,3,2,3,3,3,2,1,3,3,2,6,14,14,11,14,8,12,10,5,13,13,10,14,13,17,14,15,13,14,13,13,12,9,6,13,13,14,15,18,13,14,5,20,14,16,7,15,14,15,8,14,14,10,8,14,11,13,10,13,14,6,D/WB L,1,1,1,1,12,1,1,20,1,1,10,15,1,18,1
28011776,Jonjo Shelvey,765,27-02-1992,24,6,0,13,4,185,83,3,1,2,1,2,3,2,2,1,3,1,12,12,14,11,13,12,8,15,6,9,17,15,12,15,15,13,14,13,12,18,13,11,13,14,12,10,14,12,11,9,11,10,12,11,12,20,14,14,13,16,13,5,7,11,14,12,11,12,7,7,11,M C,1,1,10,15,5,5,1,1,1,14,20,10,10,1,1
29076105,Luke Shaw,765,12-07-1995,20,6,0,5,0,186,75,2,1,3,4,2,2,4,3,3,3,1,11,11,14,8,13,8,12,5,10,14,13,7,14,14,8,14,13,9,14,12,13,15,14,7,14,14,14,15,17,15,15,13,20,16,17,6,15,14,13,6,13,13,15,10,17,12,15,13,13,12,6,D/WB L,1,1,1,1,12,1,1,20,1,1,1,12,1,17,1
5128263,Fraser Forster,765,17-03-1988,28,6,0,0,0,201,99,19,16,14,4,16,12,16,18,13,3,12,7,1,2,3,10,11,2,1,2,3,9,4,7,6,7,14,14,16,16,10,15,17,2,9,1,15,6,12,3,13,15,20,8,11,4,20,9,17,15,5,16,6,1,13,19,8,13,20,18,15,3,GK ,20,1,1,1,1,1,1,1,1,1,1,1,1,1,1
142537,Michael Dawson,765,18-11-1983,32,4,0,13,0,188,89,1,3,3,1,3,3,2,2,1,2,1,2,8,4,9,8,4,16,6,7,12,15,12,16,9,14,13,18,11,12,16,12,17,4,18,6,14,20,20,8,9,14,17,12,13,8,20,15,14,12,6,16,8,7,12,15,16,12,14,14,14,5,D C,1,1,1,1,1,1,20,1,1,1,1,1,1,1,1
28044979,Jack Butland,765,10-03-1993,23,4,0,28,0,196,94,18,12,13,11,15,14,16,18,11,10,9,7,1,1,2,6,9,1,2,3,3,9,2,2,10,10,12,14,14,15,10,11,15,3,9,3,13,12,10,13,18,12,14,4,15,11,20,14,12,12,5,10,5,13,9,13,14,11,17,16,16,3,GK ,20,1,1,1,1,1,1,1,1,1,1,1,1,1,1
5109668,Scott Carson,765,03-09-1985,30,4,0,29,0,183,86,14,12,13,11,12,13,12,12,11,10,12,2,3,2,3,7,5,3,2,2,1,9,2,2,6,11,11,14,10,13,9,11,13,2,14,1,13,12,12,9,14,14,13,12,14,10,20,15,16,12,8,13,4,11,13,15,15,8,15,12,13,6,GK ,20,1,1,1,1,1,1,1,1,1,1,1,1,1,1
5113183,Tom Huddlestone,765,28-12-1986,29,4,0,33,3,191,98,2,3,2,3,2,1,2,4,2,3,2,14,13,10,10,15,13,7,14,10,10,18,9,10,15,14,12,14,14,13,16,12,12,9,13,9,15,16,10,8,8,13,15,15,14,8,20,10,17,12,12,10,5,15,18,16,16,16,11,11,10,8,DM/M C,1,9,1,1,1,1,11,1,1,20,20,8,8,1,1
28010312,Jack Rodwell,765,11-03-1991,25,3,0,21,2,188,80,3,4,3,2,2,3,3,1,1,1,3,4,9,11,11,12,4,14,11,3,12,13,10,12,11,5,12,12,14,11,11,13,7,5,8,9,13,14,11,13,11,14,14,16,10,11,20,15,14,10,13,11,18,10,10,5,13,10,11,11,9,4,DM/M C,1,1,1,1,1,1,12,1,1,19,20,1,1,1,1
28100266,Marcus Rashford,765,31-10-1997,18,3,1,0,0,181,73,3,1,1,1,1,1,4,2,2,2,3,5,8,14,14,13,11,8,11,3,2,11,13,5,14,14,12,8,13,11,9,12,12,17,4,14,4,12,15,18,16,13,8,12,16,17,20,14,11,12,7,12,4,10,20,10,9,17,11,13,18,4,AM/S L,1,1,20,14,18,14,1,1,1,1,12,14,14,1,1
8708271,Lukas Podolski,771,04-06-1985,31,129,48,5,0,182,83,3,3,2,2,1,2,2,2,1,2,1,10,13,13,20,14,14,8,18,9,5,15,17,5,15,8,13,14,18,8,14,12,14,9,8,13,6,15,7,11,13,16,10,20,11,13,9,13,14,10,14,18,9,14,14,12,17,18,14,4,10,14,AM/S RLC,1,1,20,17,17,17,1,1,1,1,7,15,15,1,1
890618,Bastian Schweinsteiger,771,01-08-1984,31,120,24,7,2,183,79,1,1,1,1,2,3,3,1,3,2,3,12,13,13,12,15,13,11,13,9,11,16,14,14,16,14,16,15,18,18,14,17,16,10,18,11,15,17,11,8,11,14,10,10,12,10,20,10,14,16,10,17,14,12,12,17,17,16,17,19,14,6,DM/M C,1,1,1,13,10,11,1,8,6,20,20,11,12,9,7
890613,Philipp Lahm,771,11-11-1983,32,113,5,3,0,170,62,2,1,1,1,1,3,2,3,1,1,3,7,15,12,7,15,4,13,7,10,11,13,10,18,15,12,20,10,20,18,12,19,19,10,16,9,14,19,12,12,14,8,7,12,19,12,20,16,7,18,7,17,5,17,12,17,18,15,19,18,20,13,D/WB/DM RL,1,1,1,1,1,10,1,15,20,18,14,1,10,15,20
8707357,Per Mertesacker,771,29-09-1984,31,104,4,3,0,198,90,1,2,2,2,2,1,1,3,1,1,2,3,3,5,6,13,3,16,3,5,18,11,5,18,9,8,19,12,19,17,9,17,14,4,15,4,18,19,10,7,4,15,20,9,14,9,20,14,16,17,4,15,8,1,16,10,16,17,19,19,20,1,D C,1,1,1,1,1,1,20,1,1,1,1,1,1,1,1
35002219,Mesut Ozil,771,15-10-1988,27,79,20,16,5,183,72,3,3,4,2,3,3,1,2,3,3,3,15,16,17,12,19,13,7,11,4,6,19,13,9,19,7,18,9,19,15,20,18,14,19,8,20,6,19,12,14,16,14,9,20,15,13,10,15,9,13,5,16,6,10,16,16,12,17,15,14,16,10,AM RLC,1,1,1,20,15,15,1,1,1,1,14,12,10,1,1
35011448,Thomas Muller,771,13-09-1989,26,77,32,6,1,186,74,1,1,2,2,1,2,2,2,2,3,1,7,11,11,15,13,7,12,10,10,7,12,15,8,12,18,19,13,16,18,14,17,18,15,12,20,10,17,18,12,13,15,12,12,19,14,20,19,11,17,9,18,3,16,10,16,16,19,15,10,11,10,M/AM/S RC,1,1,20,19,12,18,1,1,1,1,10,12,18,1,1
156772,Toni Kroos,771,04-01-1990,26,71,11,10,2,182,78,1,2,3,3,2,3,2,4,3,2,2,18,18,14,13,18,14,7,17,8,8,20,13,9,16,10,17,10,18,14,18,19,9,11,12,14,12,18,13,12,9,12,10,15,12,13,20,16,14,13,10,14,7,13,8,14,8,14,17,18,17,7,DM/M C,1,1,1,14,1,1,1,1,1,17,20,10,1,1,1
8718372,Manuel Neuer,771,27-03-1986,30,71,0,20,0,192,90,14,19,12,16,16,19,19,18,20,8,20,4,1,3,1,13,9,10,3,2,3,13,10,1,12,8,20,16,20,14,12,12,18,6,13,1,18,16,14,15,18,16,15,15,13,10,20,12,17,17,7,19,4,14,5,13,15,20,16,12,19,8,GK ,20,1,1,1,1,1,1,1,1,1,1,1,1,1,1
893408,Mario Gomez,771,10-07-1985,30,68,29,6,1,189,88,1,1,1,2,2,1,2,2,2,3,1,6,8,13,17,12,7,14,12,4,6,10,14,7,11,12,18,13,14,14,10,13,13,9,8,19,9,15,13,12,10,17,13,16,16,14,20,13,16,18,7,10,14,3,12,17,13,9,18,15,12,6,S ,1,1,20,1,1,1,1,1,1,1,1,1,1,1,1
35002579,Jerome Boateng,771,03-09-1988,27,65,1,15,1,192,90,3,3,2,3,2,3,2,3,1,3,3,7,14,11,6,13,5,10,7,16,18,15,7,18,13,10,17,13,16,12,14,15,11,11,11,7,15,12,9,14,13,17,17,18,14,18,20,14,18,16,8,16,6,16,6,14,7,15,11,15,9,13,D C,1,1,1,1,1,1,20,14,14,8,8,1,1,12,12
8723858,Sami Khedira,771,04-04-1987,29,65,5,15,5,189,90,4,4,2,1,3,2,1,3,2,2,1,6,10,11,13,14,8,16,12,11,15,14,10,13,14,15,15,16,15,18,13,17,18,10,12,16,17,20,19,10,11,15,14,11,10,14,20,17,16,16,12,15,19,14,15,16,9,15,18,16,17,4,DM/M C,1,1,1,8,1,1,1,1,1,19,20,1,1,1,1
35017438,Mario Gotze,771,03-06-1992,24,56,17,2,0,176,75,1,1,3,3,3,3,2,2,2,1,1,12,12,16,13,18,10,8,13,5,6,14,10,8,18,12,16,8,13,13,18,18,9,17,6,17,8,15,12,13,15,13,7,9,12,11,20,12,8,15,5,15,11,15,7,11,12,13,13,15,18,8,AM/S RLC,1,1,18,20,15,15,1,1,1,8,13,15,15,1,1
91002405,Andrea Schurrle,771,06-11-1990,25,55,20,4,3,184,74,3,3,1,2,2,2,3,1,3,2,3,9,13,15,14,12,10,8,16,6,7,12,14,8,13,17,12,9,10,12,11,11,15,13,7,15,9,13,17,17,14,12,10,10,18,17,20,15,10,10,5,14,6,14,12,18,7,14,14,11,13,12,M/AM/S RL,1,1,17,12,20,15,1,1,1,1,1,20,15,1,1
885107,Kevin Kuranyi,771,02-03-1982,34,52,19,6,2,190,88,2,3,2,2,1,2,2,3,1,4,1,7,9,9,13,10,7,18,11,5,6,11,14,8,11,16,17,16,14,14,12,12,13,10,12,14,9,14,16,8,7,13,16,10,13,9,20,10,14,15,6,13,8,4,17,10,14,12,17,15,11,12,S ,1,1,20,1,1,1,1,1,1,1,1,1,1,1,1
35007944,Mats Hummels,771,16-12-1988,27,50,4,21,5,191,92,3,1,1,3,1,1,1,3,1,3,1,5,9,12,10,14,8,15,9,8,17,15,11,17,15,12,18,14,19,13,14,17,14,9,14,10,18,16,12,9,11,17,16,14,15,12,20,14,16,16,9,14,6,7,8,13,16,14,17,18,16,10,D C,1,1,1,1,1,1,20,1,10,12,1,1,1,1,6
35015879,Benedikt Howedes,771,29-02-1988,28,40,2,22,3,187,82,1,1,3,1,3,1,1,1,2,1,1,4,8,6,8,10,4,16,5,12,18,10,8,18,9,16,14,17,10,18,8,12,17,3,14,8,15,18,12,11,10,15,15,12,16,13,20,16,14,17,10,17,12,14,10,13,17,15,18,16,13,3,D RC,1,1,1,1,1,1,20,14,16,8,8,1,1,10,12
890619,Piotr Trochowski,771,22-03-1984,32,35,2,15,2,169,70,3,3,1,3,1,3,3,3,3,1,2,16,14,13,13,14,15,10,17,8,6,13,16,8,15,9,12,9,13,13,13,12,8,14,7,11,9,11,8,10,13,14,7,16,12,10,20,10,8,10,5,11,16,12,7,15,13,10,12,13,15,13,M/AM C,1,1,1,20,14,14,1,1,1,1,18,14,14,1,1
35016427,Holger Badstuber,771,13-03-1989,27,31,1,8,2,190,84,2,1,3,3,1,3,1,3,1,2,4,14,13,7,5,12,13,10,7,12,15,14,11,14,12,9,17,11,19,16,12,18,10,6,10,5,17,18,8,10,8,13,17,20,15,14,9,12,14,17,6,14,18,10,7,14,16,12,18,17,12,3,D C,1,5,1,1,1,1,20,14,1,10,8,1,1,10,1
91013383,Marco Reus,771,31-05-1989,27,29,9,2,0,180,75,1,2,3,3,2,3,2,3,1,3,3,15,13,14,16,14,16,6,14,7,6,12,15,8,13,16,16,7,12,12,14,16,15,15,7,18,10,13,14,18,15,9,8,14,14,16,20,14,8,17,4,17,12,16,9,14,15,17,13,10,12,9,M/AM/S RLC,1,1,16,15,18,20,1,1,1,1,1,18,20,1,1
885406,Heiko Westermann,771,14-08-1983,32,27,4,2,0,190,86,2,3,2,3,1,2,3,2,1,1,1,5,8,9,8,7,10,16,10,13,14,9,7,14,7,14,11,15,8,14,8,10,17,6,14,11,13,17,16,10,6,14,16,12,18,10,20,15,17,15,9,14,6,15,14,12,16,11,18,18,13,3,D RLC,1,1,5,1,1,1,20,16,16,14,12,1,1,14,14
92030193,Julian Draxler,771,20-09-1993,22,24,2,1,1,187,75,1,2,1,1,2,1,2,1,2,3,3,13,13,16,13,17,10,9,17,8,6,14,10,8,16,10,12,9,12,10,15,11,10,15,7,13,8,12,11,15,14,10,16,18,12,13,20,14,11,8,5,15,12,13,11,17,8,10,16,12,14,13,M/AM RLC,1,1,1,18,20,15,1,1,1,1,10,20,15,1,1
6001338,Clemens Fritz,771,07-12-1980,35,22,2,1,0,183,81,3,3,3,2,1,1,3,3,3,2,2,8,11,13,7,11,6,9,7,14,11,12,8,13,11,10,12,14,13,16,9,12,12,7,15,8,11,17,14,12,11,16,10,14,17,14,20,14,13,16,8,15,9,16,5,10,17,14,17,15,12,6,D/DM/M RC,1,1,8,1,1,12,1,10,17,20,20,1,12,8,15
92016242,Jonas Hector,771,27-05-1990,26,20,1,0,0,185,75,1,1,1,3,2,3,1,1,1,2,1,11,12,11,8,12,10,8,10,14,10,13,11,15,12,12,16,12,16,16,12,15,12,9,10,13,13,18,14,12,10,13,11,20,18,15,12,16,11,17,6,17,5,16,7,10,16,15,17,17,19,3,D/WB/DM/M LC,1,1,7,10,12,1,1,20,10,17,17,12,1,20,10
35007385,Lars Bender,771,27-04-1989,27,19,4,1,0,184,77,2,1,1,1,3,3,1,1,2,3,3,7,10,8,9,12,7,12,11,13,15,13,8,17,11,15,16,18,12,17,10,14,17,5,13,13,14,19,18,11,11,14,12,10,20,13,20,17,13,18,6,18,10,15,9,14,14,16,19,15,18,2,DM/M C,1,1,1,12,1,10,1,1,14,20,20,1,10,1,12
5112098,Robert Huth,771,18-08-1984,31,19,2,2,0,191,88,2,1,3,3,1,1,2,1,2,3,3,3,6,5,7,9,12,17,9,14,15,9,10,17,9,20,14,18,11,14,6,12,18,4,15,7,16,17,16,9,6,16,15,14,14,10,20,13,17,13,18,11,4,14,17,16,14,13,10,13,9,17,D RC,1,12,8,1,1,1,20,10,15,8,1,1,1,1,1
156766,Marko Marin,771,13-03-1989,27,16,1,12,1,170,68,2,1,1,3,2,1,2,2,1,2,1,15,16,16,9,16,12,5,10,6,4,15,11,5,17,5,10,6,13,10,13,11,8,17,5,13,4,7,8,15,17,12,5,14,9,13,20,10,6,8,4,10,16,12,11,12,10,13,12,7,12,9,AM RLC,1,1,10,16,20,17,1,1,1,1,7,14,14,1,1
35011197,Marcel Schmelzer,771,22-01-1988,28,16,0,11,0,180,74,1,1,3,1,1,2,3,2,1,3,2,10,12,9,6,10,9,11,9,14,15,11,8,16,10,17,17,14,10,17,8,12,14,7,12,14,15,18,14,13,12,14,10,20,16,17,9,19,11,16,7,13,10,8,6,11,18,11,18,16,14,3,D/WB L,1,1,1,1,12,1,1,20,10,1,1,12,1,18,10
91003875,Ilkay Gundogan,771,24-10-1990,25,16,4,8,1,180,80,1,3,4,3,1,1,3,4,3,3,3,10,12,14,10,17,10,7,11,6,10,16,12,13,17,15,13,12,17,14,17,16,12,13,10,13,11,16,14,12,17,13,9,14,13,14,20,15,11,16,8,16,13,14,15,17,7,14,16,16,14,6,DM/M C,1,1,1,15,11,11,1,1,1,20,20,11,11,1,1
35008236,Max Kruse,771,19-03-1988,28,14,4,1,1,181,79,1,2,3,1,1,2,2,3,1,3,3,13,12,12,15,14,10,8,13,6,7,13,15,8,14,15,12,10,16,10,14,15,14,14,7,15,9,16,17,12,13,15,9,20,12,16,12,13,11,14,6,16,7,15,7,10,8,16,8,10,7,16,AM/S C,1,1,19,20,14,13,1,1,1,8,12,14,13,1,1
8718399,Dennis Aogo,771,14-01-1987,29,12,0,25,4,184,84,4,1,3,1,1,2,3,3,2,1,3,12,16,11,8,13,12,8,11,13,10,14,15,11,14,8,12,10,15,11,13,12,9,14,8,11,10,13,10,12,14,12,11,20,15,14,10,15,13,13,8,13,5,17,8,12,14,12,13,13,10,10,D/WB/M LC,1,1,1,10,12,10,8,20,1,14,17,12,10,20,1
890482,Rene Adler,771,15-01-1985,31,12,0,4,0,190,85,11,10,13,8,15,11,17,16,14,12,10,8,1,1,2,10,11,7,2,2,3,8,3,3,10,10,14,10,12,14,7,12,12,7,11,1,16,15,10,12,15,12,14,15,13,10,20,11,14,15,3,12,15,12,10,15,16,10,18,14,10,4,GK ,20,1,1,1,1,1,1,1,1,1,1,1,1,1,1
91013409,Shkodran Mustafi,771,17-04-1992,24,12,1,7,0,184,82,4,3,1,1,3,3,3,2,1,3,1,4,11,11,9,12,3,16,4,11,16,13,5,16,12,14,14,15,14,13,12,15,15,6,13,10,15,15,16,15,12,15,14,11,15,14,20,14,15,14,12,15,6,11,16,16,15,13,16,16,12,6,D RC,1,1,1,1,1,1,20,1,16,1,1,1,1,1,1
8428653,Hugo Lloris,769,26-12-1986,29,82,0,8,0,188,78,12,12,14,14,17,8,15,18,17,18,11,5,2,3,2,11,10,1,9,3,7,10,1,13,8,10,14,18,14,16,9,16,15,6,16,3,17,14,8,15,17,15,15,20,15,14,6,15,14,15,10,15,5,1,14,15,17,18,17,18,18,4,GK ,20,1,1,1,1,1,1,1,1,1,1,1,1,1,1
8426264,Franck Ribery,769,07-04-1983,33,81,16,13,2,170,62,3,1,2,1,1,4,1,2,1,2,1,12,13,17,15,18,14,5,15,6,7,14,12,7,17,12,14,13,15,12,15,16,16,19,9,16,8,10,12,14,16,16,6,15,13,16,20,12,9,19,8,16,15,9,11,17,10,15,10,6,7,18,M/AM LC,1,1,9,15,20,14,1,1,1,1,10,20,14,1,1
8435089,Karim Benzema,769,19-12-1987,28,81,27,5,0,184,84,1,3,2,3,3,3,1,1,2,3,3,10,11,17,16,19,12,13,13,7,7,15,14,9,18,8,14,7,18,12,18,17,8,17,10,17,8,15,11,14,14,16,11,17,11,14,20,13,14,9,4,11,8,8,8,11,12,15,9,17,18,20,S ,1,1,20,14,13,10,1,1,1,1,1,1,1,1,1
3502121,Florent Malouda,769,13-06-1980,36,80,9,1,0,177,80,1,1,1,2,2,1,1,3,3,3,2,13,15,12,12,15,10,12,14,3,7,14,13,8,14,9,13,12,16,12,13,13,12,13,11,15,10,13,12,10,12,15,8,20,13,11,12,10,14,12,5,14,7,15,12,17,14,15,12,14,14,7,M/AM LC,1,1,12,16,18,10,1,7,1,1,15,20,1,10,1
3802422,Patrice Evra,769,15-05-1981,35,80,0,11,0,174,74,3,4,2,2,2,2,1,2,2,3,2,8,14,13,7,15,8,14,4,14,14,13,9,16,15,15,15,16,17,13,11,15,19,14,18,14,17,16,14,12,13,15,9,20,17,12,9,13,11,16,14,16,4,10,18,14,17,17,14,14,14,12,D/WB L,1,1,1,1,6,1,11,20,7,1,1,15,1,19,1
8430030,Bacary Sagna,769,14-02-1983,33,64,0,12,0,181,73,3,2,2,2,3,2,1,4,3,1,1,11,13,11,5,13,7,16,8,8,14,12,5,15,14,12,14,14,15,13,13,15,15,10,8,13,14,15,16,12,12,13,12,10,18,13,20,16,15,15,8,14,9,10,16,16,16,14,14,14,17,9,D/WB RC,1,1,1,1,1,1,15,14,20,1,1,1,1,11,18
34000647,Olivier Giroud,769,30-09-1986,29,55,20,0,0,192,88,1,3,1,2,3,2,1,3,2,2,2,4,8,12,16,14,12,18,14,3,8,11,14,7,15,14,16,17,14,14,14,14,16,13,9,16,9,19,18,11,10,19,17,20,15,13,10,15,19,15,10,16,8,3,15,14,14,15,16,14,14,8,S ,1,1,20,1,1,1,1,1,1,1,1,1,1,1,1
8430055,Mathieu Valbuena,769,28-09-1984,31,52,8,0,0,167,58,1,2,2,1,3,2,4,2,1,2,3,15,15,14,7,15,15,6,11,3,4,15,14,7,15,13,12,15,13,14,16,11,17,14,11,12,10,12,14,15,18,10,5,10,16,14,20,13,7,14,13,16,8,12,13,16,14,15,13,9,11,14,AM RLC,1,1,7,20,17,17,1,1,1,1,14,13,15,1,1
8442483,Blaise Matuidi,769,09-04-1987,29,51,8,24,0,175,70,3,4,2,3,2,3,2,2,2,1,3,6,12,12,10,13,7,12,12,8,14,13,9,16,13,14,16,16,15,16,11,14,16,8,14,14,15,18,18,15,14,16,8,20,16,14,8,18,14,16,13,14,7,14,15,14,14,14,16,16,16,5,DM/M C,1,1,1,1,10,1,1,7,1,17,20,14,1,7,1
3503808,Sidney Govou,769,27-07-1979,36,49,10,15,4,175,75,3,1,2,3,1,1,3,2,3,3,3,10,10,10,5,11,10,9,13,9,5,12,14,7,14,12,9,12,11,10,13,8,9,12,15,10,10,14,11,10,11,12,9,10,13,9,20,7,11,11,12,15,12,10,5,12,15,13,11,15,15,13,M/AM RL,1,1,13,1,16,20,1,1,1,1,1,16,18,1,1
919628,Yohan Cabaye,769,14-01-1986,30,48,4,16,3,173,72,4,1,4,2,1,2,1,2,3,1,4,14,12,14,13,15,15,5,14,2,2,16,14,11,17,12,15,13,13,16,14,13,16,12,13,16,14,18,18,11,15,15,6,11,17,12,20,17,12,8,17,14,8,12,13,15,12,15,15,11,7,6,M C,1,1,1,15,1,1,1,1,1,15,20,1,1,1,1
8448722,Moussa Sissoko,769,16-08-1989,26,44,1,18,1,188,83,2,2,2,1,1,1,3,2,3,4,1,7,12,15,11,13,10,12,11,5,9,13,13,11,12,11,13,13,13,13,13,12,12,12,12,15,9,13,13,14,13,14,13,8,16,15,20,15,15,10,6,13,5,10,14,15,10,14,13,14,14,10,M/AM RC,1,1,1,16,1,20,1,1,1,1,18,1,18,1,1
876548,Alou Diarra,769,15-07-1981,34,44,0,14,1,190,79,3,2,3,1,2,2,1,3,1,1,1,4,9,8,7,11,9,15,9,8,14,11,7,14,13,15,15,16,13,15,8,12,13,6,15,7,14,14,13,8,9,16,14,8,11,9,20,12,15,12,15,16,12,10,13,16,12,13,12,12,10,15,D/DM/M C,1,1,1,1,1,1,18,1,1,20,16,1,8,1,1
8428584,Samir Nasri,769,26-06-1987,29,41,5,6,0,177,75,1,2,1,1,1,1,4,1,3,1,3,13,12,16,14,17,14,5,13,2,5,16,12,7,17,10,14,7,15,12,15,14,14,17,11,16,8,12,12,14,17,17,8,15,15,14,20,15,9,13,6,14,13,14,14,16,14,13,12,12,8,12,M/AM RLC,1,1,1,20,18,18,1,1,1,10,15,18,18,1,1
85028014,Paul Pogba,769,15-03-1993,23,38,6,13,4,191,84,3,2,1,3,1,3,3,1,1,4,2,7,12,17,15,19,15,13,18,4,11,16,12,13,18,13,14,13,15,14,16,12,17,19,12,15,12,13,15,13,15,18,16,15,17,16,20,17,17,16,14,12,5,10,17,19,12,14,14,14,13,8,M C,1,1,1,15,1,1,1,1,1,14,20,12,11,1,1
8442484,Laurent Koscielny,769,10-09-1985,30,36,1,0,0,186,75,3,1,2,1,1,3,3,3,2,4,1,2,5,8,8,13,3,17,4,4,17,12,5,19,12,16,17,18,16,15,10,14,16,5,14,10,16,15,16,15,12,14,14,8,15,14,20,15,15,18,11,16,7,8,14,15,16,15,17,15,15,5,D C,1,1,1,1,1,1,20,10,10,1,1,1,1,1,1
67086656,Antoine Griezmann,769,21-03-1991,25,34,13,6,2,175,72,3,1,4,14,1,1,1,3,2,2,2,14,17,17,18,19,15,15,14,4,5,14,13,11,17,13,15,13,14,15,15,15,17,17,14,18,10,12,15,15,15,15,9,20,15,14,15,13,10,16,6,14,5,14,13,18,12,12,14,14,8,13,AM/S LC,1,1,19,18,20,14,1,1,1,1,1,15,9,1,1
34004844,Adil Rami,769,27-12-1985,30,32,1,0,0,190,88,1,2,2,2,3,1,1,3,3,2,2,5,7,9,8,10,7,16,11,9,15,13,5,16,12,17,16,17,13,13,11,12,16,7,14,10,14,15,15,14,12,17,16,9,15,14,20,16,18,15,15,14,10,12,14,15,12,14,12,13,11,15,D C,1,1,1,1,1,1,20,1,12,5,1,1,1,1,1
919541,Yoann Gourcuff,769,11-07-1986,29,31,4,19,4,185,82,3,1,2,2,1,2,1,2,3,1,1,13,13,13,9,16,14,12,14,5,6,16,14,6,16,10,14,10,14,12,15,13,14,12,11,13,8,15,12,12,13,14,12,12,12,12,20,14,14,14,12,15,15,10,12,16,14,8,17,14,15,5,M/AM C,1,1,10,20,13,12,1,1,1,12,19,12,12,1,1
34000070,Mamadou Sakho,769,13-02-1990,26,28,2,17,1,187,83,3,2,2,2,2,3,1,3,3,2,1,4,7,10,7,11,6,17,5,12,15,14,7,16,9,15,16,16,13,11,11,13,17,10,15,12,14,14,12,13,12,12,15,20,15,14,7,16,17,14,12,15,11,5,13,16,15,14,16,11,14,14,D C,1,1,1,1,1,1,20,10,1,1,1,1,1,1,1
8434283,Lassana Diarra,769,10-03-1985,31,28,0,18,0,173,73,4,3,3,2,3,2,2,2,2,3,3,11,10,10,6,13,9,9,10,12,13,13,6,15,12,17,15,16,13,14,11,13,19,10,14,9,14,16,16,12,14,15,8,12,18,12,20,15,12,15,14,15,11,13,17,15,8,17,10,14,15,14,DM C,1,1,1,7,1,1,1,1,10,20,15,1,10,1,10
85075627,Raphael Varane,769,25-04-1993,23,28,2,15,3,191,83,1,2,2,1,3,1,3,1,1,1,4,5,9,11,6,13,8,15,9,10,17,14,10,17,14,11,15,13,14,18,11,14,12,11,9,8,17,14,14,15,13,11,17,8,16,16,20,14,14,17,6,15,14,14,12,16,13,17,14,17,16,8,D C,1,9,1,1,1,1,20,1,10,6,1,1,1,1,1
915351,Mathieu Debuchy,769,28-07-1985,30,27,2,2,0,178,78,2,2,1,1,1,1,3,2,1,1,1,8,13,13,8,12,7,14,9,12,14,11,8,16,11,14,14,17,12,14,12,13,17,11,12,13,15,14,15,13,13,13,12,9,12,13,20,13,11,14,14,14,13,18,14,13,13,15,16,13,12,8,D R,1,1,1,1,1,8,14,11,20,10,1,1,10,10,14
8442349,Dimitri Payet,769,29-03-1987,29,26,6,12,4,175,77,1,2,1,3,3,2,1,2,1,2,2,16,14,16,15,15,18,6,15,6,6,18,11,5,17,9,12,10,16,12,16,14,14,16,6,16,6,10,10,13,15,14,8,15,15,14,20,13,12,11,9,16,7,8,8,11,8,13,12,13,11,10,AM RLC,1,1,10,20,20,20,1,1,1,1,12,12,12,1,1
8428461,Steve Mandanda,769,28-03-1985,31,22,0,17,0,185,82,12,12,13,6,14,11,15,18,14,10,13,7,3,8,5,9,10,8,12,2,2,9,6,3,10,6,12,15,16,12,8,12,14,8,15,3,13,13,8,13,17,14,13,7,12,11,20,15,14,13,6,16,3,1,8,16,12,13,16,16,16,7,GK ,20,1,1,1,1,1,1,1,1,1,1,1,1,1,1
8449433,Yann M'Vila,769,29-06-1990,26,22,1,10,0,182,80,3,3,3,3,2,1,3,2,1,3,2,8,11,10,6,14,11,13,11,6,14,13,5,15,12,14,18,15,15,15,9,15,17,9,11,12,12,16,16,12,13,15,10,8,18,12,20,16,12,13,12,16,3,9,12,13,7,14,14,11,15,13,DM/M C,1,1,1,1,1,1,10,1,1,19,20,1,1,1,1
919860,Gael Clichy,769,26-07-1985,30,20,0,13,0,177,71,1,1,1,2,3,1,1,1,1,1,2,5,8,12,6,15,5,12,5,6,13,13,6,14,14,11,15,13,12,9,12,11,13,10,7,13,14,15,16,16,15,14,11,20,17,15,12,18,12,14,10,13,10,10,17,14,17,11,16,15,16,3,D/WB L,1,1,1,1,1,1,10,20,1,1,1,1,1,18,1
8428484,Abou Diaby,769,11-05-1986,30,16,1,2,0,192,79,1,3,2,3,3,3,3,3,1,4,1,5,9,14,12,15,8,10,13,8,12,13,10,11,15,12,13,12,14,10,12,9,12,16,6,14,8,11,10,13,14,17,15,14,8,15,20,11,16,7,10,13,17,13,13,12,14,12,15,9,8,6,M/AM C,1,1,1,16,13,7,1,1,1,10,20,14,8,1,1
8440961,Marvin Martin,769,10-01-1988,28,15,2,8,1,171,68,3,1,4,2,3,1,3,2,3,2,1,14,14,14,7,14,14,7,13,6,4,15,12,7,14,11,13,10,13,11,14,12,14,12,8,13,9,15,10,14,15,12,6,12,12,13,20,12,8,12,11,13,15,10,20,15,15,9,13,16,16,7,M/AM C,1,1,1,20,13,10,1,1,1,12,17,13,10,1,1
8444765,Morgan Schneiderlin,769,08-11-1989,26,15,0,3,1,181,75,1,2,2,4,1,2,2,2,1,1,2,10,8,9,8,14,7,12,5,8,12,15,12,16,15,15,15,16,10,13,15,14,14,14,12,9,15,18,18,12,12,14,11,11,18,12,20,18,13,15,13,14,6,13,17,16,12,15,15,13,14,6,DM/M C,1,1,1,10,1,1,1,1,1,18,20,1,10,1,1
85033423,Lucas Digne,769,20-07-1993,22,13,0,7,0,178,74,1,3,2,2,1,3,3,1,2,1,1,8,15,13,8,14,7,12,13,15,10,13,6,14,14,12,13,15,15,13,12,14,18,8,8,14,11,13,17,16,15,14,8,20,15,14,8,16,12,14,12,15,6,10,15,16,13,14,16,15,15,5,D/WB L,1,1,1,1,7,1,1,20,1,1,1,13,1,18,1
915732,Francois Clerc,769,18-04-1983,33,13,0,4,0,186,77,1,3,1,2,3,3,1,3,3,2,3,8,13,11,5,12,9,13,12,13,12,11,8,14,13,7,13,13,12,12,11,12,15,12,9,11,13,12,13,12,11,15,13,8,11,13,20,12,13,13,7,14,11,13,13,14,13,14,15,14,14,8,D/WB RL,1,1,1,1,10,10,1,15,20,1,1,10,12,15,17
918875,Rio Mavuba,769,08-04-1984,32,13,0,19,1,172,72,3,1,3,2,1,2,2,2,3,1,1,7,12,12,5,13,7,6,9,9,12,14,9,14,12,13,14,14,15,15,10,13,17,7,18,8,15,18,15,12,14,12,6,10,16,13,20,15,12,15,9,15,5,10,12,16,14,13,15,18,18,5,DM/M C,1,1,1,8,1,1,1,1,1,20,18,1,1,1,1
919707,Hatem Ben Arfa,769,07-03-1987,29,13,2,4,0,178,74,2,2,2,3,3,3,3,2,2,2,1,14,14,17,12,17,14,6,14,2,1,15,15,2,17,5,13,5,14,9,15,11,9,18,5,15,2,6,5,15,16,14,7,20,12,14,14,12,9,8,5,13,8,8,12,14,13,11,8,10,12,12,AM RC,1,1,15,19,13,20,1,1,1,1,1,11,14,1,1
85086702,Anthony Martial,769,05-12-1995,20,12,0,12,4,181,76,4,4,3,2,2,3,3,3,3,3,4,5,10,17,15,15,7,10,11,2,2,12,14,3,15,8,12,12,13,11,10,12,15,14,5,15,5,12,14,18,16,14,10,11,14,17,20,14,14,12,8,13,8,11,12,18,12,15,16,15,18,7,AM/S RL,1,1,19,1,20,16,1,1,1,1,1,15,14,1,1
8427430,Christophe Jallet,769,31-10-1983,32,11,1,0,0,176,68,2,1,3,2,2,2,2,3,3,2,2,8,10,10,7,11,8,10,11,12,11,13,12,14,12,9,14,15,13,12,11,12,17,8,14,14,11,18,18,14,14,12,10,10,14,13,20,17,13,15,9,13,8,13,17,13,15,16,16,16,18,5,D/WB R,1,1,1,1,1,1,10,10,20,1,1,1,13,10,20
85104424,Kingsley Coman,769,13-06-1996,20,11,1,9,2,178,71,2,2,1,1,2,1,2,2,1,2,1,12,13,15,11,14,10,8,11,8,6,12,10,7,14,15,11,13,10,11,12,10,12,15,6,12,8,13,15,17,16,13,10,10,16,19,20,12,10,14,6,15,8,15,16,18,7,14,13,13,17,14,M/AM RLC,1,1,12,15,20,18,1,1,1,1,1,20,18,1,1
34011687,Alexandre Lacazette,769,28-05-1991,25,10,1,11,4,175,73,1,3,3,3,3,3,3,1,2,3,1,5,10,15,17,15,10,11,12,5,5,14,15,5,16,8,15,12,15,14,13,15,15,15,14,14,10,10,12,16,16,15,9,10,15,16,20,13,15,14,8,14,7,10,8,16,17,13,15,15,14,5,AM/S RL,1,1,20,1,15,16,1,1,1,1,1,1,1,1,1
3503514,Olivier Kapo,769,27-09-1980,35,9,3,14,3,183,72,1,2,2,2,3,1,3,1,3,3,1,11,12,13,10,13,10,11,12,4,4,12,15,4,13,6,12,7,12,10,12,11,11,14,11,11,5,11,6,6,7,10,8,20,9,5,10,6,9,12,8,15,12,11,8,14,12,10,11,15,15,6,AM RLC,1,1,14,20,16,17,1,1,1,1,14,14,14,1,1
18031822,Eliaquim Mangala,769,13-02-1991,25,8,0,21,2,187,84,3,1,1,1,1,2,1,3,2,3,1,7,7,8,10,11,8,15,8,12,15,11,10,14,10,19,14,16,10,12,8,9,16,8,10,11,12,15,17,13,15,16,15,20,17,16,15,17,19,11,10,12,10,10,15,14,12,11,14,13,13,5,D C,1,1,1,1,1,1,20,12,5,12,1,1,1,5,1
34001572,Maxime Gonalons,769,10-03-1989,27,8,0,6,0,187,76,3,2,3,2,2,1,1,3,3,1,2,5,7,11,5,14,5,14,9,5,15,15,8,14,13,15,16,15,14,12,14,14,18,8,17,9,12,18,15,13,14,15,14,10,17,12,20,17,15,14,13,16,4,12,10,14,17,12,15,13,13,6,D/DM C,1,1,1,1,1,1,16,1,1,20,14,1,1,1,1
8428716,Kevin Gameiro,769,09-05-1987,29,8,1,4,1,172,70,3,1,2,2,1,2,3,2,2,1,3,10,12,14,15,16,10,12,13,5,2,14,16,4,15,6,16,13,14,14,14,14,14,14,10,18,6,15,15,17,15,14,8,14,16,16,20,14,9,14,6,16,7,5,6,16,13,9,14,15,13,8,S ,1,1,20,1,8,10,1,1,1,1,1,1,1,1,1
85081880,N'Golo Kante,769,29-03-1991,25,8,1,0,0,169,68,3,2,3,3,2,1,2,3,4,1,1,6,12,14,10,12,8,10,12,6,12,14,8,18,14,10,17,15,14,15,14,12,15,13,5,13,15,17,19,16,14,15,7,9,18,15,20,18,13,15,10,13,5,10,18,13,10,12,13,15,15,8,DM/M C,1,1,1,14,10,12,1,1,1,18,20,12,12,1,1
34009731,Josuha Guilavogui,769,19-09-1990,25,7,0,15,2,187,77,3,3,2,2,3,2,3,3,1,2,1,5,8,10,9,11,7,12,9,10,14,12,7,14,12,18,16,14,11,10,11,12,15,9,11,13,15,16,18,13,12,15,14,9,17,15,20,17,16,13,13,12,9,10,11,15,12,14,13,13,11,6,DM/M C,1,1,1,10,1,1,14,1,8,20,20,1,1,1,8
8448716,Etienne Capoue,769,11-07-1988,27,7,1,13,0,189,80,1,4,4,3,1,3,1,1,2,2,2,5,11,12,8,14,8,14,7,7,11,15,10,14,15,13,17,15,15,14,13,13,11,11,8,11,14,15,16,12,13,16,13,8,16,13,20,17,15,10,13,15,14,10,8,15,15,15,12,14,11,14,DM/M C,1,1,1,4,1,1,7,1,12,20,20,7,7,1,12
29114975,Nabil Fekir,769,18-07-1993,22,5,1,1,0,173,72,1,3,1,3,3,3,3,3,3,2,2,14,13,16,14,16,14,5,11,5,5,15,11,5,16,8,13,9,14,13,15,13,15,16,5,13,5,9,10,15,16,14,5,20,14,15,5,12,14,13,11,13,8,14,10,15,14,10,13,10,10,13,AM/S RLC,1,1,20,20,17,18,1,1,1,1,1,1,1,1,1
11133,Gianluigi Buffon,776,28-01-1978,38,161,0,11,0,192,91,14,20,20,16,14,12,17,19,18,16,13,1,1,1,1,9,1,1,1,1,1,8,4,1,8,5,17,17,17,16,7,17,18,12,20,1,20,6,10,8,14,14,14,7,12,8,20,10,15,19,5,17,12,1,12,16,20,18,16,15,14,4,GK ,20,1,1,1,1,1,1,1,1,1,1,1,1,1,1
703963,Andrea Pirlo,776,19-05-1979,37,115,13,46,16,177,68,3,1,2,3,2,3,1,2,3,3,2,17,17,14,10,20,19,7,15,4,10,20,15,10,18,10,19,13,20,15,20,17,14,19,17,9,15,16,6,6,10,12,7,15,12,6,20,10,9,18,9,17,9,14,13,13,18,19,18,20,19,6,DM/M C,1,1,1,8,1,1,1,1,1,20,20,1,1,1,1
829412,Daniele De Rossi,776,24-07-1983,32,106,18,16,3,184,83,1,1,1,1,1,1,1,1,1,1,1,8,10,11,12,14,8,16,11,6,15,16,13,15,14,19,18,19,15,8,15,12,20,12,19,12,17,17,14,11,13,14,12,13,10,11,20,12,15,14,16,8,17,11,9,16,20,12,14,12,8,13,DM/M C,1,1,1,1,1,1,15,1,1,20,20,1,1,1,1
831079,Giorgio Chiellini,776,14-08-1984,31,88,7,26,6,187,86,2,1,4,2,3,3,3,1,1,1,2,2,10,8,8,10,2,16,11,20,17,12,4,18,8,17,16,20,15,15,10,13,18,8,14,13,17,16,19,12,10,17,14,20,17,15,7,16,18,16,15,16,14,14,12,15,17,14,14,16,18,11,D LC,1,1,1,1,1,1,20,16,1,1,1,1,1,11,1
7982726,Riccardo Montolivo,776,18-01-1985,31,64,2,25,4,182,79,2,2,2,3,1,3,3,3,2,3,1,15,13,12,7,16,14,8,15,8,13,15,14,14,16,13,13,9,14,14,15,13,12,13,13,11,13,15,13,11,12,13,10,14,12,11,20,13,12,14,13,12,15,12,7,14,14,12,15,16,17,9,DM/M C,1,1,1,10,1,1,1,1,1,19,20,1,1,1,1
1410956,Leonardo Bonucci,776,01-05-1987,29,62,4,0,0,190,86,2,2,1,4,1,1,1,1,2,1,2,9,9,12,9,13,12,14,12,8,16,17,13,15,13,11,20,16,14,16,19,12,17,13,19,7,20,16,14,14,13,15,14,9,15,14,20,16,15,16,11,14,5,11,14,15,16,14,18,14,9,3,D C,1,19,1,1,1,1,20,1,1,7,1,1,1,1,1
6100324,Andrea Barzagli,776,08-05-1981,35,61,0,15,0,187,87,1,3,2,2,3,1,3,1,4,1,2,2,2,8,3,11,2,13,3,3,18,12,10,16,11,8,18,14,16,19,10,18,16,3,12,5,19,17,12,11,10,18,13,10,8,12,20,13,14,20,3,12,14,5,9,13,13,17,18,18,20,7,D C,1,10,1,1,1,1,20,1,12,1,1,1,1,1,1
12230,Francesco Totti,776,27-09-1976,39,58,9,8,4,180,82,1,1,1,1,1,1,1,1,1,1,1,17,16,14,16,20,18,8,18,4,4,19,17,6,19,12,19,15,18,15,20,17,15,18,20,14,6,17,12,8,9,10,8,16,12,7,20,8,9,15,15,13,10,16,5,13,20,10,16,9,9,13,S C,1,1,20,15,1,1,1,1,1,1,1,1,1,1,1
3804675,Alberto Gilardino,776,05-07-1982,33,57,19,30,22,184,79,1,3,1,2,1,2,3,3,2,2,2,3,7,11,16,15,6,16,9,3,5,12,10,7,14,11,16,14,14,16,10,15,15,13,11,16,5,13,15,12,13,12,13,9,16,12,20,11,12,14,10,17,8,8,10,13,13,14,20,17,18,5,S ,1,1,20,1,1,1,1,1,1,1,1,1,1,1,1
1400716,Claudio Marchisio,776,19-01-1986,30,54,5,19,1,180,71,1,1,1,1,1,2,2,1,3,3,2,5,12,13,11,16,6,8,14,7,14,17,12,15,16,13,16,15,17,14,15,17,15,13,14,14,16,18,18,14,13,15,9,12,11,13,20,14,13,15,6,15,12,13,7,15,18,15,16,15,16,6,DM/M C,1,1,1,11,7,1,1,1,1,20,20,11,12,1,1
1400480,Antonio Candreva,776,28-02-1987,29,44,6,13,0,181,72,2,2,3,3,1,3,3,2,1,1,2,16,15,14,13,16,15,6,15,6,7,15,16,6,16,10,14,14,14,12,14,14,17,16,15,16,8,11,12,14,15,12,10,12,15,15,20,15,12,13,7,16,8,17,13,15,14,15,17,9,13,9,M/AM RLC,1,1,5,15,15,20,1,1,1,1,10,14,19,1,8
3804527,Antonio Cassano,776,12-07-1982,33,39,10,19,7,175,80,3,1,3,1,2,2,2,3,3,2,1,12,14,17,14,19,10,10,12,8,4,20,16,5,20,14,17,12,13,12,20,16,12,20,19,15,5,12,10,7,8,14,8,12,13,8,20,9,12,16,9,19,12,12,14,12,15,9,8,9,12,17,S ,1,1,20,1,1,1,1,1,1,1,1,1,1,1,1
836911,Alberto Aquilani,776,07-07-1984,31,38,5,20,5,186,77,1,1,1,1,1,1,1,1,1,1,1,13,12,12,12,15,12,11,14,6,11,16,13,13,15,12,13,9,14,12,15,14,12,11,6,12,13,15,14,11,11,14,11,12,9,11,20,11,13,13,13,15,13,12,10,12,13,14,16,15,12,6,M C,1,1,1,10,1,1,1,1,1,12,20,1,1,1,1
6100081,Christian Maggio,776,11-02-1982,34,34,0,2,0,184,79,1,2,1,2,2,1,3,1,3,2,1,8,12,12,10,12,4,13,8,13,12,12,2,15,13,13,14,15,11,13,12,12,11,7,10,14,15,13,15,12,13,15,13,9,15,14,20,13,14,12,9,15,12,14,10,12,15,14,15,18,10,7,D/WB/M R,1,1,1,1,1,10,1,1,20,1,1,1,19,1,19
43001238,Mario Balotelli,776,12-08-1990,25,33,13,16,6,189,88,2,4,1,2,3,1,2,3,2,1,2,12,13,15,15,15,17,16,16,8,5,14,19,7,16,13,14,12,16,9,14,12,7,15,8,12,5,2,4,13,15,14,14,12,12,15,20,13,15,7,16,13,14,11,8,13,4,11,8,3,4,16,S ,1,1,20,6,9,8,1,1,1,1,1,1,1,1,1
43037008,Mattia De Sciglio,776,20-10-1992,23,30,0,5,0,183,74,1,1,3,2,4,1,1,2,2,1,1,6,13,12,2,13,5,12,6,12,14,13,8,14,13,12,13,12,13,14,11,12,13,5,11,12,14,15,13,15,14,13,11,12,10,15,20,13,11,12,11,11,14,15,18,14,17,12,15,19,17,9,D/WB RL,1,1,1,1,1,1,8,20,20,1,1,13,13,17,17
5124471,Giuseppe Rossi,776,01-02-1987,29,30,7,22,11,173,72,2,2,2,3,1,2,3,3,2,3,3,13,15,15,16,17,14,9,15,4,5,14,16,7,17,8,13,11,17,14,15,15,16,15,13,15,8,13,14,15,14,10,8,20,5,14,9,11,7,14,12,12,19,12,17,15,13,15,15,14,12,3,S ,1,1,20,13,9,9,1,1,1,1,1,1,1,1,1
6701095,Thiago Motta,776,28-08-1982,33,30,1,0,0,187,83,1,3,4,2,1,1,2,3,1,1,3,13,13,12,8,16,10,16,13,10,14,16,13,16,15,13,15,14,16,15,14,14,13,11,13,10,17,18,10,10,12,17,14,20,12,12,10,13,16,16,16,15,13,11,16,16,13,15,12,8,8,11,DM/M C,1,1,1,10,1,1,12,1,1,20,20,1,1,1,1
7990445,Emanuele Giaccherini,776,05-05-1985,31,29,4,0,0,167,60,3,3,1,1,1,1,2,1,1,3,2,11,15,15,12,13,8,7,12,6,5,15,11,8,15,15,15,12,14,13,14,14,15,16,4,17,9,14,15,15,14,8,4,14,10,14,20,10,7,16,11,15,15,15,8,16,16,12,14,13,11,9,M/AM RLC,1,1,7,15,18,19,1,1,1,1,19,15,20,10,8
7990060,Matteo Darmian,776,02-12-1989,26,26,1,1,0,183,70,3,2,3,2,1,1,1,2,3,3,2,4,10,10,7,13,4,14,4,10,14,13,4,17,13,12,13,14,13,13,9,13,13,5,10,10,13,14,15,13,14,14,11,11,17,14,20,15,14,15,13,13,7,18,10,14,15,15,15,18,18,8,D/WB RL,1,1,1,1,1,1,14,18,20,1,1,10,13,17,19
6100739,Fabio Quagliarella,776,31-01-1983,33,25,7,1,0,180,79,2,3,3,2,1,3,3,1,1,3,3,6,12,12,14,14,12,14,17,2,2,14,14,5,16,14,15,13,14,14,13,14,16,16,10,15,6,14,14,13,10,12,12,12,14,14,20,12,12,16,13,17,11,10,9,12,16,12,15,15,10,10,S ,1,1,20,1,1,1,1,1,1,1,1,1,1,1,1
836928,Giampaolo Pazzini,776,02-08-1984,31,25,4,21,5,180,74,1,3,2,3,1,3,3,1,1,3,1,2,6,12,14,12,6,15,12,8,6,11,15,6,12,15,14,15,13,13,10,13,15,8,12,15,9,15,13,13,13,13,12,11,12,13,20,12,13,13,13,13,13,5,13,13,11,11,16,12,13,11,S ,1,1,20,1,1,1,1,1,1,1,1,1,1,1,1
7982798,Marco Parolo,776,25-01-1985,31,24,0,0,0,186,82,1,1,1,1,1,1,1,1,1,1,1,4,8,11,14,14,11,17,16,5,11,13,12,16,14,14,13,12,15,14,13,13,16,13,11,18,15,18,18,11,12,11,13,15,14,11,20,17,13,15,13,16,6,17,12,16,16,15,19,18,18,3,DM/M C,1,1,1,8,9,1,1,1,1,17,20,5,1,1,1
1400720,Sebastian Giovinco,776,26-01-1987,29,23,1,29,4,163,61,2,1,1,3,1,2,1,3,2,3,1,14,15,15,16,16,18,8,13,7,4,16,17,6,17,10,14,13,13,12,15,8,15,16,11,14,7,13,17,15,19,8,4,15,13,14,20,15,7,14,3,13,4,11,15,18,15,13,14,14,12,17,S LC,1,1,20,15,15,14,1,1,1,1,1,10,7,1,1
829403,Simone Pepe,776,30-08-1983,32,23,0,12,1,178,73,1,1,2,1,1,2,1,3,3,1,4,13,12,13,12,11,14,10,12,6,12,13,10,9,12,20,16,19,12,14,11,11,18,15,13,16,16,18,20,12,14,9,8,9,7,12,20,13,10,15,15,15,15,18,13,14,9,19,17,5,8,12,M/AM RL,1,1,10,14,15,20,1,9,9,1,8,16,19,9,9
7983987,Ignazio Abate,776,12-11-1986,29,22,1,18,2,180,73,1,3,1,2,3,3,4,1,3,2,3,3,12,13,4,11,2,10,6,14,13,12,4,13,11,15,14,14,11,13,9,12,14,6,13,13,13,15,14,17,16,13,10,7,12,17,20,15,12,13,13,12,14,8,11,13,18,13,16,15,12,7,D/WB R,1,1,1,1,1,7,1,1,20,1,1,1,12,1,18
7987827,Domenico Criscito,776,30-12-1986,29,22,0,30,1,183,75,7,1,1,1,1,7,1,5,2,20,3,6,13,12,8,13,8,13,8,11,14,13,14,13,16,9,16,13,12,13,12,15,18,8,9,14,15,12,12,13,14,13,11,20,17,14,14,14,10,15,7,13,5,16,13,14,17,15,17,15,14,8,D L,1,7,1,1,1,1,14,20,10,5,5,13,1,15,5
829216,Angelo Palombo,776,25-09-1981,34,22,0,18,0,177,77,1,1,1,1,1,1,1,1,2,3,4,8,8,9,7,10,12,11,12,8,15,14,10,13,12,16,15,16,13,14,13,13,18,7,19,10,16,19,19,9,8,16,8,9,20,11,20,11,9,14,7,14,3,12,8,13,19,14,19,18,18,8,D/DM/M C,1,1,1,1,1,1,18,1,1,20,20,1,1,1,1
43041177,Alessandro Florenzi,776,11-03-1991,25,21,2,18,5,173,67,1,2,2,2,3,3,2,3,2,2,4,15,13,12,13,13,12,11,16,5,9,13,12,12,14,14,12,15,12,9,13,10,18,16,9,15,9,15,17,16,15,11,8,9,16,15,20,16,9,15,8,16,5,20,5,14,19,13,18,19,13,3,D/WB/M/AM RC,1,1,1,12,14,18,1,8,19,5,17,8,20,8,18
7988517,Andrea Ranocchia,776,16-02-1988,28,21,0,14,1,195,81,2,1,2,1,1,2,1,3,3,2,3,5,6,8,9,10,5,19,7,7,14,12,8,14,10,14,12,15,12,10,11,12,13,6,14,6,12,14,15,12,11,15,19,9,12,12,20,13,14,10,14,14,10,7,14,15,15,10,15,12,13,5,D C,1,1,1,1,1,1,20,1,1,1,1,1,1,1,1
43036636,Stephan El Shaarawy,776,27-10-1992,23,20,3,5,3,178,72,3,3,3,3,2,2,1,2,1,2,1,11,12,15,15,15,11,8,13,7,4,13,14,6,15,9,15,11,14,12,13,14,13,16,7,17,7,10,11,15,15,11,8,10,10,16,20,12,10,11,6,13,12,14,10,16,12,9,12,15,15,8,AM/S RL,1,1,18,12,20,15,1,1,1,1,1,10,7,1,1
1401013,Salvatore Sirigu,776,12-01-1987,29,17,0,4,0,192,80,13,11,14,5,17,12,15,15,13,13,12,3,2,6,3,9,7,7,1,2,3,9,4,2,8,10,14,16,15,14,8,14,15,7,13,3,15,16,9,11,14,15,15,5,13,12,20,13,13,18,8,15,7,12,15,18,15,14,16,16,13,2,GK ,20,1,1,1,1,1,1,1,1,1,1,1,1,1,1
3801411,Cristian Zaccardo,776,21-12-1981,34,17,1,21,2,184,77,2,1,2,2,1,2,3,2,2,1,3,7,10,6,8,12,6,14,11,10,15,11,6,14,11,14,14,13,13,12,9,11,14,5,11,11,15,14,12,11,10,11,12,10,12,11,20,12,13,16,12,8,5,13,8,8,15,14,17,18,16,5,D RC,1,3,1,1,1,1,19,13,20,1,1,1,1,5,14
7980410,Graziano Pelle,776,15-07-1985,30,17,7,16,4,193,86,1,1,1,1,1,1,1,1,1,1,1,4,6,9,16,16,8,17,13,5,9,14,12,7,14,14,15,13,15,13,13,14,18,16,12,16,9,12,11,9,14,17,16,10,13,9,20,14,17,13,15,16,9,8,14,16,14,17,16,7,3,13,S ,1,1,20,8,1,1,1,1,1,1,1,1,1,1,1
827054,Alessandro Diamanti,776,02-05-1983,33,17,1,0,0,180,73,1,1,1,3,2,2,2,2,3,2,3,18,18,16,12,16,19,8,19,5,7,15,16,8,16,15,13,14,14,13,14,13,19,17,15,12,8,12,11,13,12,13,9,20,15,11,6,8,12,11,14,15,4,14,9,14,13,12,15,12,15,9,AM RLC,1,1,12,20,17,17,1,1,1,1,15,11,11,1,1
3801706,Daniele Bonera,776,31-05-1981,35,16,0,34,0,183,74,3,1,2,2,2,1,1,3,1,2,2,2,9,8,4,10,2,14,8,13,16,11,5,14,11,13,14,13,15,14,9,13,14,5,15,10,16,15,14,11,11,10,11,9,9,11,20,13,13,13,15,8,15,12,13,13,17,13,16,15,16,8,D RC,1,1,1,1,1,1,20,10,18,1,1,1,1,1,2
43010773,Ciro Immobile,776,20-02-1990,26,15,1,16,8,185,80,2,3,3,3,2,4,2,2,2,1,2,6,7,12,17,11,7,16,13,5,5,11,14,6,12,15,16,15,14,14,9,13,16,10,10,18,6,11,15,13,12,16,11,12,16,16,20,15,13,15,8,15,7,7,7,16,10,12,15,12,12,9,S ,1,1,20,1,9,6,1,1,1,1,1,1,1,1,1
43026579,Marco Verratti,776,05-11-1992,23,15,1,7,0,165,60,2,3,2,1,1,1,3,3,2,1,3,14,14,16,8,16,13,6,10,6,11,18,15,12,18,16,15,15,17,13,17,15,14,18,12,10,12,15,16,14,16,16,6,12,13,14,20,15,11,16,14,15,10,12,14,15,16,14,14,13,10,6,DM/M C,1,1,1,14,1,1,1,1,1,16,20,1,1,1,1
